Q2_3,Q2_8,Q2_7,Q9_2A,Q3_7,Q2_13,Q5_2,Q6_2,Financial_Vulnerability
34,6,4,10000.0,1,0,29000,21000,8000
21,4,4,50000.0,2,1,290000,346000,-56000
52,3,0,0.0,0,1,60000,73000,-13000
31,2,4,0.0,2,1,104000,80000,24000
32,2,4,0.0,2,1,107000,87000,20000
24,2,4,0.0,1,1,119000,193000,-74000
32,5,4,80000.0,1,1,268000,263000,5000
38,4,3,1000.0,1,1,37000,44000,-7000
30,2,1,0.0,2,1,55000,68000,-13000
40,6,1,4200.0,1,1,125000,146000,-21000
27,2,1,37000.0,1,1,125000,135000,-10000
30,2,4,0.0,1,1,134000,178000,-44000
33,1,4,0.0,1,0,119000,98000,21000
28,6,4,5000.0,0,1,40000,38000,2000
24,14,4,10500.0,1,1,105000,75000,30000
30,4,3,15500.0,1,0,141000,139000,2000
30,9,3,21000.0,2,1,151000,378000,-227000
18,3,4,0.0,1,1,119000,177000,-58000
25,4,4,0.0,1,1,119000,205000,-86000
45,5,0,25500.0,0,0,34000,45000,-11000
65,3,3,47000.0,1,1,166000,150000,16000
40,3,4,6000.0,1,1,24000,22000,2000
36,6,0,0.0,2,1,141000,130000,11000
43,6,0,5000.0,1,0,30000,33000,-3000
22,5,4,3500.0,1,1,47000,35000,12000
30,9,5,1000.0,0,1,77000,134000,-57000
45,2,4,0.0,2,1,119000,110000,9000
54,5,4,2500.0,0,1,32000,26000,6000
46,2,4,0.0,1,1,253000,244000,9000
32,9,4,5000.0,1,1,119000,119000,0
30,3,4,0.0,2,1,134000,89000,45000
33,4,4,31000.0,0,1,45000,37000,8000
35,9,4,4500.0,0,1,15000,10000,5000
60,10,4,8500.0,2,1,106000,80000,26000
33,9,2,1000.0,1,1,37000,29000,8000
34,9,4,6000.0,0,1,32000,22000,10000
54,3,4,0.0,1,1,107000,107000,0
40,6,4,300.0,2,1,45000,30000,15000
28,6,5,80000.0,1,1,230000,216000,14000
35,5,0,4500.0,0,1,74000,71000,3000
20,2,4,0.0,2,1,119000,102000,17000
30,2,4,5000.0,0,1,47000,32000,15000
50,5,3,55000.0,1,1,151000,199000,-48000
21,3,3,56000.0,0,0,136000,139000,-3000
20,5,0,5000.0,0,1,22000,22000,0
55,4,4,0.0,0,1,74000,59000,15000
60,2,4,0.0,1,1,107000,81000,26000
60,12,4,5700.0,0,1,92000,69000,23000
45,9,4,6450.0,0,1,32000,21000,11000
28,6,3,8000.0,1,1,92000,147000,-55000
41,5,4,5000.0,1,1,32000,30000,2000
32,5,1,2100.0,0,0,74000,66000,8000
29,6,4,5000.0,1,1,52000,34000,18000
22,5,4,6000.0,0,1,25000,15000,10000
18,4,0,35500.0,0,1,66000,60000,6000
27,6,4,3700.0,1,1,30000,22000,8000
27,4,1,40800.0,0,0,82000,76000,6000
35,4,1,1000.0,1,1,74000,84000,-10000
34,6,0,4700.0,0,1,65000,71000,-6000
45,6,5,20000.0,2,1,137000,163000,-26000
34,3,2,30000.0,1,0,112000,142000,-30000
50,2,4,0.0,1,1,104000,84000,20000
30,5,3,24000.0,1,0,126000,156000,-30000
37,1,4,0.0,1,1,119000,84000,35000
36,6,3,200000.0,1,1,258000,248000,10000
40,9,1,0.0,1,1,60000,52000,8000
45,10,4,60000.0,1,1,195000,210000,-15000
68,3,5,78000.0,1,1,163000,215000,-52000
35,3,2,5000.0,0,1,107000,80000,27000
52,9,0,0.0,1,1,147000,130000,17000
20,4,4,2300.0,0,1,60000,69000,-9000
30,2,4,1500.0,1,0,60000,91000,-31000
28,5,4,0.0,2,0,119000,83000,36000
26,4,3,25000.0,2,1,125000,135000,-10000
32,2,4,0.0,1,1,119000,171000,-52000
28,4,4,4700.0,0,1,40000,33000,7000
34,1,4,5000.0,0,1,22000,17000,5000
62,6,4,8000.0,0,1,45000,36000,9000
32,3,4,0.0,1,1,119000,134000,-15000
32,2,4,0.0,2,1,119000,109000,10000
30,2,4,0.0,1,0,119000,110000,9000
70,6,4,11000.0,0,1,37000,31000,6000
26,9,4,7200.0,0,1,40000,35000,5000
28,1,4,0.0,2,1,107000,85000,22000
65,5,4,5000.0,0,1,30000,26000,4000
35,4,4,7500.0,1,1,40000,27000,13000
53,2,4,0.0,1,1,104000,152000,-48000
34,5,5,4000.0,1,1,119000,151000,-32000
34,2,4,0.0,2,1,112000,89000,23000
37,2,4,0.0,2,1,104000,112000,-8000
40,9,0,0.0,1,1,22000,33000,-11000
28,2,4,0.0,2,0,119000,204000,-85000
18,4,0,5500.0,1,1,52000,55000,-3000
25,3,1,0.0,1,1,30000,31000,-1000
24,6,4,2500.0,0,1,51000,46000,5000
26,10,2,1000.0,2,1,37000,29000,8000
30,3,2,1000.0,1,1,15000,11000,4000
35,6,2,1000.0,1,1,30000,25000,5000
27,9,1,1200.0,1,0,111000,129000,-18000
60,5,1,1000.0,1,1,134000,166000,-32000
55,6,4,1200.0,1,1,98000,74000,24000
30,5,1,1200.0,1,1,104000,114000,-10000
57,12,2,1000.0,1,1,119000,97000,22000
55,4,2,2000.0,1,1,62000,52000,10000
31,4,2,1000.0,1,0,22000,20000,2000
40,2,4,62000.0,1,1,31000,19000,12000
33,4,4,0.0,1,1,37000,22000,15000
33,6,2,1000.0,1,1,15000,12000,3000
23,13,4,0.0,1,1,90000,78000,12000
28,6,1,0.0,1,1,60000,53000,7000
26,5,2,3000.0,1,1,83000,79000,4000
31,3,1,0.0,0,0,89000,87000,2000
35,5,5,6200.0,1,1,150000,240000,-90000
50,5,2,1000.0,1,0,15000,13000,2000
35,1,0,0.0,2,0,24000,27000,-3000
33,4,1,6000.0,1,1,104000,115000,-11000
38,5,1,40000.0,2,1,52000,68000,-16000
28,5,2,1000.0,1,1,30000,24000,6000
27,5,2,1000.0,1,0,15000,12000,3000
29,5,1,1200.0,2,0,135000,125000,10000
22,5,5,12500.0,1,1,60000,106000,-46000
34,3,1,0.0,1,0,59000,78000,-19000
25,4,2,17000.0,1,1,45000,56000,-11000
27,4,5,1000.0,1,0,30000,52000,-22000
36,12,2,51000.0,1,1,37000,30000,7000
24,6,2,1000.0,1,1,30000,25000,5000
28,4,1,0.0,1,1,60000,55000,5000
27,6,3,61000.0,1,1,364000,287000,77000
34,9,2,1000.0,1,0,54000,43000,11000
28,2,2,5000.0,1,1,71000,63000,8000
27,9,2,11000.0,1,1,18000,13000,5000
56,5,3,84200.0,1,1,356000,214000,142000
45,5,2,1000.0,1,1,15000,20000,-5000
22,12,4,1200.0,1,1,148000,123000,25000
45,5,1,1200.0,1,1,52000,53000,-1000
22,4,2,4000.0,1,0,89000,88000,1000
40,12,1,0.0,1,1,119000,103000,16000
30,10,4,0.0,1,1,30000,21000,9000
42,5,4,0.0,1,1,30000,41000,-11000
32,6,2,1000.0,2,1,30000,23000,7000
27,5,1,0.0,1,0,71000,92000,-21000
28,6,2,11800.0,1,1,104000,101000,3000
21,5,4,0.0,1,0,30000,32000,-2000
40,15,2,1000.0,1,1,22000,18000,4000
21,5,3,32500.0,1,0,141000,365000,-224000
22,9,4,8000.0,1,1,114000,69000,45000
19,9,4,10000.0,1,1,104000,72000,32000
36,4,3,1000.0,0,1,15000,26000,-11000
31,5,2,1000.0,1,1,44000,34000,10000
50,9,5,1000.0,0,0,90000,162000,-72000
31,12,0,0.0,0,1,202000,209000,-7000
26,5,4,0.0,1,0,148000,123000,25000
32,5,1,0.0,1,1,58000,77000,-19000
35,5,4,0.0,1,1,134000,218000,-84000
70,4,4,99000.0,2,1,306000,221000,85000
24,9,4,75000.0,1,1,223000,282000,-59000
39,4,4,0.0,1,1,160000,130000,30000
38,4,0,6000.0,1,0,177000,199000,-22000
62,3,3,25000.0,1,1,154000,220000,-66000
30,4,4,50000.0,1,1,180000,148000,32000
20,2,4,30000.0,1,1,137000,88000,49000
33,11,5,50000.0,1,1,514000,374000,140000
28,6,1,0.0,1,0,153000,170000,-17000
65,2,1,35000.0,1,1,43000,40000,3000
32,12,4,0.0,0,0,134000,108000,26000
42,5,0,0.0,2,1,126000,120000,6000
25,6,3,35000.0,0,1,196000,175000,21000
22,3,3,18000.0,1,0,61000,128000,-67000
45,2,4,45000.0,0,1,61000,53000,8000
22,4,3,66000.0,1,1,151000,148000,3000
70,5,1,0.0,1,1,104000,133000,-29000
40,11,1,0.0,2,1,126000,159000,-33000
27,5,1,0.0,2,1,112000,110000,2000
32,2,1,7000.0,2,1,101000,111000,-10000
20,6,3,43000.0,2,0,128000,136000,-8000
32,6,3,45000.0,2,1,134000,162000,-28000
48,9,4,2000.0,0,1,89000,140000,-51000
40,9,3,3000.0,2,1,21000,19000,2000
56,3,4,7000.0,2,1,21000,13000,8000
50,9,0,0.0,2,1,148000,131000,17000
25,4,3,24000.0,0,1,82000,118000,-36000
45,5,0,0.0,0,1,80000,87000,-7000
57,5,2,57000.0,0,1,302000,245000,57000
35,9,3,21000.0,2,1,110000,126000,-16000
35,3,4,20000.0,0,1,134000,126000,8000
60,9,4,30000.0,2,1,196000,188000,8000
18,5,1,13000.0,2,1,97000,87000,10000
48,3,4,21000.0,0,1,52000,86000,-34000
28,12,1,6000.0,0,1,52000,47000,5000
45,9,1,3000.0,0,1,66000,61000,5000
23,9,0,46000.0,0,1,104000,88000,16000
18,2,4,0.0,2,1,107000,81000,26000
37,4,4,12000.0,1,1,22000,14000,8000
50,10,3,158000.0,1,1,371000,330000,41000
25,6,3,43000.0,1,1,143000,210000,-67000
48,5,0,5000.0,1,1,29000,33000,-4000
30,2,4,0.0,1,1,194000,275000,-81000
25,3,4,0.0,1,1,268000,306000,-38000
22,4,3,57000.0,1,1,68000,172000,-104000
35,5,0,11000.0,1,1,69000,64000,5000
28,5,4,4000.0,1,1,27000,17000,10000
43,3,2,6500.0,0,0,45000,45000,0
50,6,4,7000.0,1,1,17000,15000,2000
40,4,4,8500.0,1,1,24000,16000,8000
30,2,4,0.0,2,1,89000,59000,30000
29,2,4,0.0,1,1,104000,77000,27000
23,5,4,52000.0,1,1,84000,109000,-25000
36,5,4,6000.0,1,1,16000,14000,2000
20,9,4,7000.0,0,1,31000,21000,10000
26,3,4,0.0,2,1,119000,184000,-65000
60,6,0,3500.0,1,1,17000,18000,-1000
21,3,4,0.0,1,1,238000,144000,94000
20,2,4,0.0,1,1,119000,151000,-32000
65,6,4,5000.0,0,0,30000,18000,12000
26,4,4,0.0,1,0,119000,133000,-14000
36,9,4,5000.0,0,1,36000,25000,11000
38,5,4,3300.0,0,1,45000,30000,15000
21,5,4,1000.0,0,1,25000,21000,4000
25,2,4,0.0,2,1,119000,95000,24000
30,5,4,26000.0,0,1,40000,32000,8000
26,5,4,5000.0,0,0,32000,23000,9000
20,5,4,20900.0,0,1,59000,41000,18000
32,2,4,0.0,1,0,119000,100000,19000
18,5,3,2000.0,1,1,66000,205000,-139000
40,9,1,1000.0,1,1,74000,89000,-15000
22,9,5,3200.0,1,1,60000,95000,-35000
32,3,1,0.0,1,1,37000,46000,-9000
37,4,2,210000.0,1,1,892000,915000,-23000
27,6,1,32200.0,0,1,112000,141000,-29000
30,6,2,33000.0,1,1,30000,24000,6000
50,4,2,1000.0,1,1,30000,21000,9000
45,5,2,1000.0,1,1,15000,12000,3000
33,6,2,29000.0,1,1,30000,25000,5000
28,10,1,6200.0,1,1,141000,171000,-30000
57,9,2,2000.0,1,1,107000,129000,-22000
35,6,1,6900.0,1,1,89000,95000,-6000
34,5,2,57000.0,1,1,268000,704000,-436000
25,5,1,51200.0,1,1,126000,113000,13000
32,10,2,4000.0,2,1,286000,325000,-39000
36,4,0,500.0,1,1,45000,45000,0
65,9,1,1200.0,1,1,178000,191000,-13000
19,4,1,0.0,1,1,71000,69000,2000
30,9,1,0.0,1,1,82000,66000,16000
30,5,1,1200.0,1,1,45000,45000,0
30,3,3,68000.0,1,1,394000,371000,23000
30,2,2,6000.0,1,1,95000,116000,-21000
50,5,2,1000.0,1,1,15000,12000,3000
18,10,2,1000.0,1,1,37000,41000,-4000
20,6,0,3000.0,1,1,37000,32000,5000
50,13,2,1000.0,1,1,37000,36000,1000
65,5,3,259000.0,1,1,565000,288000,277000
30,5,4,0.0,1,1,119000,85000,34000
80,6,4,10000.0,0,1,74000,66000,8000
54,12,1,1000.0,1,1,54000,45000,9000
45,9,1,3100.0,1,1,75000,97000,-22000
65,9,4,4500.0,0,1,30000,21000,9000
24,3,0,2000.0,0,1,30000,30000,0
55,5,3,8000.0,1,1,94000,84000,10000
30,3,5,3000.0,1,1,66000,112000,-46000
35,9,0,0.0,1,1,74000,67000,7000
44,4,4,51000.0,1,1,98000,66000,32000
51,9,3,196000.0,1,1,879000,503000,376000
35,6,4,3000.0,1,1,157000,126000,31000
37,5,5,70000.0,1,1,298000,258000,40000
23,4,3,50000.0,2,1,218000,241000,-23000
26,10,4,185000.0,2,0,300000,228000,72000
30,3,3,96000.0,2,1,257000,185000,72000
18,10,3,32000.0,1,1,159000,309000,-150000
50,6,1,0.0,2,1,141000,139000,2000
28,9,4,0.0,2,1,144000,104000,40000
60,9,5,50000.0,1,1,226000,214000,12000
60,6,3,105000.0,1,1,549000,454000,95000
65,6,4,100000.0,2,1,194000,144000,50000
27,9,3,247000.0,1,1,505000,523000,-18000
55,4,3,36980.0,2,1,144000,148000,-4000
45,4,3,68000.0,1,1,270000,198000,72000
20,5,5,106000.0,1,1,241000,297000,-56000
40,6,1,0.0,1,1,97000,86000,11000
48,6,3,17000.0,2,1,156000,176000,-20000
24,5,4,0.0,2,1,104000,160000,-56000
26,5,4,20000.0,2,1,144000,98000,46000
54,3,0,0.0,2,0,128000,114000,14000
35,4,4,28000.0,0,1,47000,40000,7000
50,5,4,29000.0,0,1,32000,21000,11000
35,6,2,260000.0,1,1,832000,565000,267000
35,4,4,0.0,1,1,134000,89000,45000
22,4,2,26000.0,2,0,15000,13000,2000
38,5,4,16000.0,1,0,45000,33000,12000
58,5,4,84300.0,1,1,66000,81000,-15000
20,4,1,15000.0,1,1,89000,109000,-20000
47,6,1,60500.0,1,1,134000,138000,-4000
50,2,4,0.0,1,1,119000,90000,29000
30,5,1,130000.0,1,0,104000,98000,6000
35,5,4,8000.0,1,0,15000,20000,-5000
40,4,4,3500.0,0,1,32000,30000,2000
20,5,4,0.0,1,1,130000,106000,24000
25,5,4,0.0,2,0,119000,83000,36000
33,4,0,3000.0,1,0,52000,48000,4000
48,4,4,25900.0,0,1,62000,51000,11000
55,6,4,0.0,1,1,104000,88000,16000
59,6,4,0.0,1,1,134000,104000,30000
21,6,4,0.0,1,0,74000,44000,30000
32,6,4,0.0,1,1,119000,85000,34000
63,2,4,0.0,2,1,119000,176000,-57000
38,6,2,7000.0,0,1,89000,126000,-37000
32,5,1,3050.0,1,1,45000,44000,1000
30,5,2,31000.0,1,1,15000,15000,0
56,6,4,600.0,1,1,66000,41000,25000
27,5,3,26000.0,0,1,112000,175000,-63000
28,4,4,6000.0,1,1,44000,37000,7000
40,4,4,0.0,1,1,134000,88000,46000
42,3,4,0.0,1,0,125000,146000,-21000
21,4,3,46000.0,1,0,151000,151000,0
52,5,4,0.0,1,1,119000,77000,42000
36,4,3,94000.0,1,1,564000,425000,139000
56,4,4,174000.0,1,1,644000,467000,177000
32,3,4,139000.0,1,1,573000,416000,157000
30,4,1,0.0,2,1,90000,91000,-1000
34,4,4,175000.0,1,1,653000,381000,272000
32,3,4,171000.0,1,1,613000,396000,217000
62,1,1,3500.0,1,1,40000,48000,-8000
29,6,3,2500.0,1,1,321000,247000,74000
42,5,4,175874.0,1,1,442000,300000,142000
52,5,1,20000.0,1,1,261000,219000,42000
38,5,4,248000.0,1,1,362000,226000,136000
37,4,3,12000.0,1,1,201000,264000,-63000
45,6,4,319550.0,1,1,502000,304000,198000
30,4,0,48500.0,1,1,76000,74000,2000
40,4,4,170000.0,1,1,605000,329000,276000
32,6,3,13000.0,1,1,421000,341000,80000
60,9,4,79000.0,1,1,582000,314000,268000
27,6,4,229000.0,1,1,723000,378000,345000
48,9,4,82000.0,1,1,502000,316000,186000
29,4,3,24500.0,1,1,225000,161000,64000
20,5,4,161000.0,1,1,622000,357000,265000
38,2,4,50000.0,1,1,201000,282000,-81000
60,5,4,136000.0,0,1,542000,308000,234000
20,5,5,103000.0,1,1,180000,222000,-42000
31,4,3,53000.0,1,0,321000,241000,80000
40,3,3,56500.0,1,1,362000,271000,91000
45,2,0,48000.0,1,1,76000,97000,-21000
26,5,5,9000.0,1,1,432000,346000,86000
75,2,2,14000.0,1,1,241000,198000,43000
26,5,3,81000.0,0,1,482000,394000,88000
25,5,3,4000.0,1,1,30000,33000,-3000
38,3,4,60000.0,1,1,502000,361000,141000
26,2,3,75000.0,1,1,602000,429000,173000
20,5,3,57000.0,1,1,261000,215000,46000
48,3,4,118000.0,1,0,442000,262000,180000
28,4,1,3000.0,1,0,104000,101000,3000
26,5,3,66000.0,1,1,421000,323000,98000
35,4,3,105000.0,1,1,482000,301000,181000
18,4,4,54000.0,0,1,321000,231000,90000
23,5,4,67000.0,1,1,362000,219000,143000
25,4,4,48000.0,1,1,308000,264000,44000
41,3,3,49000.0,0,1,365000,106000,259000
35,3,4,32000.0,1,0,381000,263000,118000
24,5,4,47000.0,1,1,362000,209000,153000
30,5,4,497085.0,1,0,702000,414000,288000
45,2,4,5500.0,1,1,261000,152000,109000
26,4,3,3000.0,1,0,30000,29000,1000
32,5,4,171700.0,1,0,362000,219000,143000
29,4,4,136000.0,1,0,542000,326000,216000
62,2,1,50000.0,1,1,48000,41000,7000
35,5,4,177886.0,1,1,402000,305000,97000
35,4,4,370000.0,1,1,502000,373000,129000
28,9,5,10000.0,1,1,532000,415000,117000
32,2,4,24000.0,1,1,362000,226000,136000
45,4,3,96000.0,1,0,578000,440000,138000
33,4,4,58000.0,1,1,482000,329000,153000
35,4,3,41500.0,1,1,381000,274000,107000
24,5,3,116000.0,1,0,663000,401000,262000
30,5,3,92000.0,1,1,362000,383000,-21000
56,5,3,35000.0,1,1,321000,306000,15000
40,3,4,45500.0,1,1,362000,231000,131000
20,3,4,63000.0,1,0,402000,267000,135000
47,4,0,35000.0,1,1,72000,69000,3000
18,5,5,7500.0,1,1,452000,343000,109000
19,6,3,227500.0,1,1,723000,376000,347000
28,4,4,35000.0,1,1,352000,214000,138000
36,6,1,5500.0,1,1,180000,167000,13000
18,4,1,5000.0,1,1,89000,105000,-16000
33,4,4,4000.0,1,0,291000,213000,78000
50,9,1,0.0,1,1,362000,312000,50000
39,3,4,2000.0,1,1,24000,20000,4000
47,4,0,3000.0,1,1,271000,267000,4000
25,4,1,0.0,1,0,64000,64000,0
58,3,4,38000.0,1,1,352000,234000,118000
41,2,1,12500.0,1,1,66000,71000,-5000
28,3,3,320000.0,1,1,743000,283000,460000
26,2,1,500.0,1,1,64000,66000,-2000
25,4,1,5740.88,1,0,140000,172000,-32000
36,3,0,7000.0,1,1,84000,83000,1000
30,4,3,69000.0,1,1,402000,340000,62000
24,3,3,53000.0,1,0,332000,196000,136000
65,4,3,62500.0,1,1,452000,167000,285000
55,4,4,565000.0,1,1,1205000,630000,575000
39,2,4,24000.0,1,1,542000,357000,185000
35,5,0,0.0,1,1,180000,156000,24000
40,4,4,115000.0,1,1,702000,463000,239000
33,9,4,35500.0,1,1,683000,455000,228000
20,5,3,37000.0,0,1,346000,337000,9000
23,4,4,65000.0,1,1,402000,281000,121000
22,5,3,93000.0,1,0,602000,426000,176000
31,6,4,318000.0,1,1,602000,311000,291000
45,2,3,135686.0,1,1,261000,172000,89000
18,5,4,35000.0,1,1,442000,260000,182000
45,4,4,226500.0,1,1,402000,299000,103000
30,4,4,66000.0,1,1,563000,312000,251000
22,5,4,35000.0,1,1,442000,361000,81000
32,5,3,198000.0,1,1,884000,482000,402000
25,2,4,0.0,0,0,281000,193000,88000
50,5,3,6000.0,1,1,20000,26000,-6000
20,4,4,69000.0,1,1,402000,279000,123000
30,5,4,34000.0,1,1,362000,210000,152000
29,4,1,29000.0,1,1,241000,224000,17000
46,5,0,5000.0,1,1,372000,305000,67000
38,6,5,10000.0,1,1,622000,413000,209000
50,5,4,7500.0,1,1,51000,40000,11000
28,5,4,26000.0,1,1,321000,236000,85000
28,2,1,12000.0,1,1,57000,75000,-18000
28,4,1,0.0,1,1,60000,58000,2000
35,5,4,80000.0,1,1,602000,322000,280000
25,4,4,53000.0,1,1,402000,261000,141000
35,4,4,210000.0,1,1,502000,369000,133000
21,4,4,136000.0,0,0,542000,308000,234000
45,5,3,93000.0,1,0,563000,479000,84000
36,4,4,95000.0,1,1,602000,361000,241000
23,5,0,0.0,1,1,301000,312000,-11000
32,3,3,9000.0,0,1,271000,270000,1000
35,3,4,203000.0,1,1,1005000,692000,313000
27,4,4,78000.0,1,1,414000,308000,106000
35,5,3,363500.0,1,1,964000,397000,567000
52,3,3,59000.0,1,1,321000,264000,57000
41,6,5,8000.0,1,0,402000,355000,47000
26,9,4,469287.0,1,0,702000,404000,298000
19,4,3,102000.0,1,1,362000,294000,68000
33,4,3,71000.0,1,1,462000,381000,81000
45,4,4,6000.0,1,1,40000,50000,-10000
60,4,1,7000.0,1,1,80000,90000,-10000
54,2,5,7000.0,1,1,381000,304000,77000
18,4,1,7000.0,1,1,60000,75000,-15000
32,4,4,91000.0,1,0,582000,319000,263000
29,9,4,138000.0,1,1,602000,340000,262000
50,2,4,0.0,1,1,171000,130000,41000
45,5,4,66000.0,1,1,362000,228000,134000
43,4,1,3000.0,1,1,74000,67000,7000
43,3,3,25000.0,1,1,261000,129000,132000
31,5,5,9000.0,1,0,391000,351000,40000
43,4,4,69000.0,1,1,402000,268000,134000
30,6,4,245000.0,1,1,402000,302000,100000
60,4,5,50000.0,1,1,702000,456000,246000
36,3,4,250000.0,1,1,402000,266000,136000
35,3,3,56500.0,1,1,362000,290000,72000
30,2,1,0.0,1,1,89000,95000,-6000
34,5,4,7500.0,1,1,231000,157000,74000
35,3,3,38000.0,1,1,241000,218000,23000
30,4,4,23000.0,1,1,201000,153000,48000
31,2,3,91000.0,1,1,542000,447000,95000
62,5,4,238000.0,1,1,723000,472000,251000
35,5,4,36000.0,1,1,663000,405000,258000
20,3,1,8000.0,1,1,66000,84000,-18000
35,3,4,170000.0,1,1,563000,312000,251000
56,4,3,55000.0,1,0,362000,297000,65000
48,6,3,51000.0,1,0,482000,575000,-93000
31,6,4,81000.0,1,0,452000,287000,165000
29,4,4,70000.0,1,0,301000,188000,113000
44,4,0,3500.0,1,1,231000,225000,6000
70,6,3,7000.0,1,1,362000,734000,-372000
50,2,2,7000.0,1,1,100000,112000,-12000
40,4,4,188000.0,1,1,341000,227000,114000
18,4,0,10000.0,1,1,156000,139000,17000
29,4,3,46000.0,1,1,381000,167000,214000
24,3,4,100000.0,1,1,301000,174000,127000
45,4,4,72000.0,1,1,381000,256000,125000
40,5,3,309000.0,1,1,462000,392000,70000
65,4,4,7000.0,1,1,60000,56000,4000
52,6,4,65000.0,1,1,362000,312000,50000
25,4,5,9000.0,1,1,482000,380000,102000
19,5,3,159000.0,1,0,683000,417000,266000
27,5,4,188000.0,1,0,321000,189000,132000
42,2,3,12000.0,1,1,301000,240000,61000
36,3,4,305000.0,1,1,502000,354000,148000
40,4,3,102000.0,1,1,261000,238000,23000
21,3,5,10000.0,1,0,643000,381000,262000
40,2,1,1500.0,1,1,36000,40000,-4000
35,3,4,165000.0,1,0,702000,477000,225000
30,4,4,47000.0,1,1,399000,233000,166000
32,3,0,0.0,1,0,72000,73000,-1000
27,5,4,0.0,1,0,281000,178000,103000
28,3,3,189000.0,1,1,362000,215000,147000
32,4,4,94000.0,1,1,582000,343000,239000
60,4,4,16500.0,1,1,121000,95000,26000
60,5,3,12000.0,1,1,462000,313000,149000
22,6,3,61000.0,1,0,362000,291000,71000
31,4,4,100000.0,1,0,301000,176000,125000
25,4,4,65000.0,1,1,563000,304000,259000
57,5,3,520000.0,1,1,1406000,542000,864000
54,3,4,45000.0,1,1,160000,139000,21000
27,5,1,4000.0,1,1,311000,242000,69000
40,6,3,68000.0,0,1,452000,260000,192000
36,6,3,60000.0,1,1,514000,400000,114000
34,6,4,137000.0,1,1,634000,403000,231000
19,4,4,27500.0,1,1,421000,293000,128000
36,3,4,251000.0,1,0,502000,370000,132000
45,5,1,4500.0,1,1,100000,134000,-34000
32,5,5,3000.0,1,1,442000,310000,132000
45,5,4,34500.0,1,1,352000,221000,131000
65,4,0,8000.0,1,1,246000,254000,-8000
19,5,4,82000.0,1,1,474000,348000,126000
49,5,3,59000.0,1,1,844000,583000,261000
30,6,5,11000.0,1,1,462000,346000,116000
19,4,3,259000.0,1,1,381000,310000,71000
62,9,1,17000.0,1,1,550000,404000,146000
24,6,4,110000.0,1,1,622000,331000,291000
55,4,4,138000.0,1,1,563000,337000,226000
36,5,3,81000.0,1,1,482000,357000,125000
68,6,4,18000.0,1,1,421000,262000,159000
34,4,0,0.0,1,1,289000,328000,-39000
37,5,4,110000.0,1,1,301000,337000,-36000
30,4,4,70000.0,1,1,602000,317000,285000
30,5,5,11000.0,1,0,452000,327000,125000
32,4,3,44000.0,1,1,402000,335000,67000
25,4,5,10500.0,1,1,412000,301000,111000
45,4,4,90000.0,1,1,482000,306000,176000
26,3,4,210000.0,1,0,502000,383000,119000
30,4,4,70000.0,1,0,602000,316000,286000
18,4,3,16500.0,1,1,209000,162000,47000
32,3,4,3000.0,1,1,301000,182000,119000
60,4,3,41500.0,1,1,362000,274000,88000
37,3,4,80000.0,1,1,261000,175000,86000
32,2,2,8000.0,1,1,20000,17000,3000
39,4,5,8000.0,1,1,341000,304000,37000
60,3,5,9000.0,1,1,381000,358000,23000
26,2,4,292500.0,1,1,402000,278000,124000
42,6,4,58000.0,1,1,426000,277000,149000
35,2,2,14500.0,1,1,341000,299000,42000
38,5,3,29000.0,1,0,241000,257000,-16000
23,4,3,34500.0,1,0,301000,222000,79000
30,4,5,2500.0,1,1,40000,50000,-10000
48,6,5,14000.0,1,1,412000,274000,138000
50,5,3,69000.0,1,1,410000,278000,132000
25,3,3,6000.0,1,1,121000,189000,-68000
37,5,4,34500.0,1,1,563000,341000,222000
39,4,3,17500.0,1,1,301000,236000,65000
28,3,4,19500.0,1,0,261000,340000,-79000
39,6,4,187000.0,1,1,783000,472000,311000
26,3,4,189000.0,1,1,321000,239000,82000
40,3,1,7000.0,1,1,66000,63000,3000
20,2,4,260000.0,1,1,563000,362000,201000
35,4,4,36000.0,1,1,442000,293000,149000
40,3,3,11000.0,1,1,121000,213000,-92000
29,4,5,9000.0,1,1,442000,290000,152000
59,2,3,61000.0,1,1,462000,178000,284000
42,5,4,82000.0,1,1,462000,296000,166000
27,4,5,12000.0,1,1,602000,408000,194000
67,3,3,6000.0,1,1,121000,88000,33000
33,2,4,51000.0,1,1,432000,252000,180000
26,3,3,70000.0,1,1,410000,332000,78000
38,2,3,33000.0,1,0,301000,246000,55000
40,3,3,39000.0,1,1,362000,344000,18000
23,6,3,80000.0,1,1,482000,399000,83000
42,3,3,57000.0,1,1,421000,173000,248000
28,3,4,31000.0,1,1,341000,219000,122000
25,3,3,380000.0,1,0,1205000,451000,754000
18,3,3,40000.0,1,1,241000,176000,65000
30,2,5,7500.0,1,1,442000,371000,71000
35,4,3,70000.0,1,1,410000,339000,71000
45,4,3,49000.0,1,1,442000,220000,222000
44,3,1,8500.0,1,1,70000,79000,-9000
18,4,0,0.0,1,0,72000,66000,6000
60,5,4,129000.0,1,0,702000,451000,251000
30,4,4,250000.0,1,0,362000,255000,107000
38,5,4,177000.0,1,1,683000,439000,244000
30,3,4,310000.0,1,0,803000,539000,264000
24,4,3,78000.0,1,1,563000,461000,102000
45,3,4,102000.0,1,1,482000,332000,150000
59,4,4,2000.0,1,1,301000,205000,96000
34,4,1,7000.0,1,1,60000,80000,-20000
27,4,3,51000.0,1,1,381000,290000,91000
30,3,3,88000.0,1,1,524000,370000,154000
32,5,5,210000.0,1,1,402000,361000,41000
18,4,4,150000.0,1,1,402000,273000,129000
30,4,5,0.0,1,1,321000,325000,-4000
44,5,4,137000.0,0,1,566000,339000,227000
55,9,4,99000.0,1,1,587000,327000,260000
38,5,4,88000.0,1,1,663000,346000,317000
29,4,3,211000.0,1,1,743000,414000,329000
34,6,4,54000.0,1,1,352000,235000,117000
35,3,0,0.0,1,1,64000,55000,9000
34,5,5,8000.0,1,1,362000,303000,59000
40,4,3,68000.0,1,1,502000,221000,281000
22,3,5,100000.0,1,1,651000,501000,150000
45,4,3,6000.0,1,1,40000,46000,-6000
20,4,3,71000.0,1,1,452000,374000,78000
38,4,3,207000.0,1,1,783000,320000,463000
24,4,3,70000.0,1,1,410000,276000,134000
42,5,4,55000.0,1,1,482000,312000,170000
25,3,3,82000.0,1,1,482000,355000,127000
26,5,5,12000.0,1,1,542000,361000,181000
47,4,4,60000.0,1,1,362000,274000,88000
60,4,4,140000.0,1,1,602000,395000,207000
25,6,4,65000.0,1,1,362000,228000,134000
25,6,4,100000.0,1,1,743000,422000,321000
38,4,4,67000.0,1,1,362000,284000,78000
30,4,3,3000.0,1,1,20000,24000,-4000
44,3,5,7000.0,1,1,341000,333000,8000
32,3,3,65000.0,1,0,702000,430000,272000
27,6,4,66000.0,1,1,602000,387000,215000
42,5,4,108000.0,1,1,803000,508000,295000
36,3,3,323000.0,1,1,1205000,483000,722000
80,5,3,7000.0,0,1,301000,275000,26000
55,3,4,130000.0,1,1,702000,501000,201000
26,3,4,88000.0,1,1,362000,228000,134000
21,3,3,58000.0,1,0,201000,187000,14000
60,4,1,6000.0,1,1,30000,25000,5000
30,2,2,2000.0,1,1,29000,29000,0
54,3,5,8000.0,1,1,622000,463000,159000
62,5,5,5000.0,1,1,482000,342000,140000
49,3,5,7000.0,1,1,502000,332000,170000
29,3,4,426874.0,1,1,542000,303000,239000
42,4,5,5000.0,1,1,362000,340000,22000
36,4,3,35000.0,1,1,321000,236000,85000
36,4,1,5000.0,1,1,72000,67000,5000
58,6,4,34000.0,1,0,462000,283000,179000
29,4,4,11000.0,1,1,40000,30000,10000
36,5,5,11000.0,1,0,482000,296000,186000
43,5,5,9000.0,1,1,412000,293000,119000
20,6,5,12000.0,1,1,412000,272000,140000
35,5,5,29000.0,1,1,563000,387000,176000
42,3,5,10000.0,1,1,362000,431000,-69000
21,4,3,68000.0,1,1,502000,207000,295000
40,4,0,2500.0,1,1,271000,229000,42000
32,4,4,30000.0,1,1,381000,240000,141000
27,4,4,20000.0,1,1,482000,280000,202000
27,4,4,209000.0,1,1,992000,675000,317000
29,2,0,0.0,1,1,72000,66000,6000
26,5,5,157521.0,1,1,542000,480000,62000
30,4,4,103000.0,1,1,743000,466000,277000
33,3,1,8000.0,1,1,72000,83000,-11000
35,3,5,200000.0,1,1,402000,293000,109000
25,4,3,39000.0,1,1,362000,345000,17000
25,4,3,5000.0,1,1,121000,273000,-152000
23,4,3,79000.0,1,1,602000,412000,190000
56,4,4,0.0,1,1,151000,225000,-74000
27,4,3,85000.0,1,1,506000,314000,192000
48,4,0,0.0,1,1,72000,70000,2000
40,4,4,150000.0,1,1,402000,279000,123000
29,4,3,6000.0,1,1,180000,334000,-154000
26,5,5,8500.0,1,1,412000,292000,120000
40,10,4,631000.0,1,1,1667000,836000,831000
35,6,4,155000.0,1,1,715000,429000,286000
36,4,1,0.0,1,1,70000,68000,2000
32,4,3,56000.0,1,1,341000,251000,90000
30,4,4,104000.0,1,0,763000,420000,343000
32,3,4,136000.0,1,1,522000,271000,251000
21,5,4,28000.0,1,1,502000,328000,174000
32,5,4,138000.0,1,1,575000,329000,246000
36,6,3,230000.0,1,1,1005000,695000,310000
35,3,1,0.0,1,1,64000,68000,-4000
60,4,4,55000.0,1,1,341000,211000,130000
20,6,3,100000.0,1,0,602000,464000,138000
43,2,2,14000.0,1,1,372000,297000,75000
26,4,4,0.0,1,1,160000,228000,-68000
38,3,3,51000.0,1,1,30000,30000,0
58,5,3,13000.0,1,1,321000,385000,-64000
47,2,2,15000.0,1,1,381000,273000,108000
27,2,5,34500.0,1,1,301000,299000,2000
30,5,5,10000.0,1,1,381000,304000,77000
52,3,3,62000.0,1,1,402000,324000,78000
27,4,5,672412.0,1,1,702000,472000,230000
39,2,2,15000.0,1,1,381000,344000,37000
27,5,3,81000.0,1,1,482000,318000,164000
35,3,4,68000.0,1,1,381000,257000,124000
43,4,5,5000.0,1,1,352000,331000,21000
32,4,5,110000.0,1,1,402000,336000,66000
32,5,4,127000.0,1,1,614000,411000,203000
24,4,3,203000.0,1,1,884000,478000,406000
32,4,4,82000.0,1,1,663000,428000,235000
38,4,4,25000.0,1,1,151000,153000,-2000
80,3,3,47000.0,0,0,231000,176000,55000
30,4,0,0.0,0,1,100000,98000,2000
33,3,0,0.0,1,1,30000,25000,5000
35,4,2,7200.0,0,1,54000,48000,6000
65,1,5,6000.0,0,1,30000,51000,-21000
25,4,4,20000.0,1,1,51000,44000,7000
50,10,0,2500.0,0,1,44000,43000,1000
53,9,4,2300.0,1,1,64000,111000,-47000
35,3,1,0.0,0,1,34000,39000,-5000
28,3,3,112000.0,1,1,456000,439000,17000
58,3,3,53000.0,1,1,159000,416000,-257000
55,4,2,36000.0,1,0,643000,413000,230000
23,9,3,55000.0,1,1,478000,421000,57000
50,4,4,98000.0,1,1,317000,216000,101000
43,5,3,37000.0,1,0,380000,333000,47000
35,4,0,1000.0,1,1,28000,28000,0
28,5,3,55000.0,1,1,475000,493000,-18000
25,8,0,20000.0,1,1,90000,107000,-17000
33,10,2,1000.0,1,1,54000,52000,2000
33,8,3,53000.0,1,1,496000,439000,57000
24,8,3,54000.0,1,0,478000,416000,62000
37,5,3,48000.0,2,1,490000,442000,48000
55,10,4,35000.0,1,1,93000,77000,16000
32,9,3,88000.0,1,0,521000,519000,2000
19,5,5,1000.0,1,1,54000,85000,-31000
60,8,0,0.0,1,1,32000,27000,5000
45,8,3,3000.0,1,1,133000,103000,30000
28,4,4,0.0,1,1,24000,19000,5000
25,10,3,165000.0,0,1,788000,456000,332000
29,3,5,31000.0,1,1,437000,389000,48000
38,5,3,49000.0,1,1,372000,343000,29000
34,5,3,71000.0,0,1,474000,436000,38000
35,8,2,1000.0,1,0,60000,56000,4000
25,12,4,0.0,1,0,66000,43000,23000
35,5,0,2000.0,1,1,74000,70000,4000
27,5,0,1000.0,1,1,30000,37000,-7000
40,3,5,42000.0,1,1,271000,324000,-53000
41,4,5,41000.0,1,1,355000,416000,-61000
27,10,3,62000.0,1,1,439000,415000,24000
67,4,4,18000.0,1,1,241000,358000,-117000
35,9,3,407000.0,1,1,1032000,732000,300000
31,9,0,0.0,1,0,20000,19000,1000
20,4,4,1200.0,1,1,24000,18000,6000
50,5,0,26100.0,1,1,70000,88000,-18000
47,8,5,1000.0,1,1,64000,96000,-32000
20,8,0,2400.0,1,1,90000,94000,-4000
28,5,5,1200.0,1,1,51000,87000,-36000
59,3,4,8000.0,1,1,48000,32000,16000
49,9,4,12008.0,1,0,128000,83000,45000
25,5,0,2500.0,1,1,51000,59000,-8000
35,15,4,2300.0,1,1,93000,56000,37000
25,8,5,2100.0,1,1,86000,149000,-63000
30,12,4,1000.0,1,1,42000,36000,6000
46,4,4,0.0,1,1,86000,73000,13000
28,9,4,12008.0,1,1,64000,38000,26000
38,5,4,0.0,1,1,40000,24000,16000
25,4,1,0.0,1,1,100000,87000,13000
30,5,4,8000.0,1,1,109000,87000,22000
26,9,4,0.0,1,1,40000,33000,7000
18,9,4,0.0,1,1,20000,20000,0
18,5,0,1000.0,1,1,36000,39000,-3000
35,3,4,23000.0,1,1,40000,28000,12000
29,5,3,45000.0,0,1,260000,346000,-86000
29,8,5,68000.0,1,1,645000,482000,163000
24,5,4,1200.0,1,1,25000,16000,9000
40,5,4,33000.0,1,1,44000,36000,8000
45,9,4,0.0,1,1,66000,45000,21000
49,10,5,49000.0,0,0,582000,511000,71000
60,8,5,50000.0,1,0,109000,136000,-27000
36,4,4,0.0,1,1,24000,20000,4000
28,8,5,16000.0,0,1,411000,294000,117000
24,4,3,65000.0,0,0,452000,519000,-67000
41,4,3,78000.0,0,1,434000,260000,174000
65,5,4,31000.0,1,1,223000,269000,-46000
65,4,5,86000.0,1,1,413000,317000,96000
23,4,4,0.0,2,0,72000,54000,18000
53,4,4,24500.0,1,1,30000,26000,4000
48,4,5,1000.0,1,1,37000,55000,-18000
66,2,4,0.0,0,1,89000,64000,25000
35,4,3,41000.0,0,1,301000,222000,79000
30,4,4,70000.0,0,1,404000,415000,-11000
34,4,2,31000.0,0,1,207000,170000,37000
55,5,3,40000.0,0,1,242000,208000,34000
38,5,3,39200.0,0,0,303000,220000,83000
59,2,4,25000.0,1,1,74000,59000,15000
62,5,0,0.0,0,1,84000,78000,6000
20,5,3,39000.0,0,0,359000,304000,55000
68,3,4,25000.0,1,0,171000,201000,-30000
38,2,3,28020.0,1,1,213000,156000,57000
18,2,3,724000.0,0,1,1536000,969000,567000
56,9,3,20200.0,0,1,121000,99000,22000
32,3,3,46000.0,0,1,229000,190000,39000
25,9,3,30000.0,0,0,209000,195000,14000
29,3,3,58500.0,0,1,291000,280000,11000
35,1,4,40000.0,1,1,118000,171000,-53000
18,8,4,14600.0,0,1,48000,43000,5000
25,5,5,60000.0,1,1,263000,227000,36000
35,4,4,1200.0,0,1,72000,60000,12000
30,3,3,7200.0,2,0,93000,102000,-9000
45,8,0,43500.0,1,0,24000,24000,0
18,4,5,57000.0,1,1,151000,245000,-94000
35,5,3,42000.0,1,1,175000,135000,40000
24,2,2,246200.0,1,1,1107000,1162000,-55000
25,3,4,33000.0,0,1,96000,63000,33000
25,4,3,52000.0,0,1,241000,210000,31000
26,5,3,6000.0,1,1,209000,151000,58000
35,5,3,13000.0,1,1,151000,152000,-1000
42,3,2,224000.0,1,1,1667000,1208000,459000
24,5,0,1200.0,0,1,36000,34000,2000
42,2,3,33000.0,0,1,180000,134000,46000
28,8,3,60000.0,0,1,426000,581000,-155000
42,2,4,20000.0,0,1,95000,137000,-42000
28,4,2,43000.0,0,1,592000,490000,102000
28,4,3,5000.0,1,1,30000,70000,-40000
65,4,0,0.0,0,1,46000,46000,0
22,4,2,125000.0,1,1,649000,786000,-137000
26,5,2,129000.0,1,1,452000,462000,-10000
45,9,5,64000.0,1,0,434000,426000,8000
35,8,1,0.0,1,1,54000,54000,0
40,4,5,8000.0,1,1,312000,283000,29000
40,2,0,0.0,2,1,34000,34000,0
35,4,3,160000.0,1,1,446000,205000,241000
34,4,4,20000.0,2,0,189000,141000,48000
23,6,2,195000.0,0,1,967000,664000,303000
42,5,4,130000.0,0,1,394000,353000,41000
50,4,5,38200.0,0,1,268000,249000,19000
39,3,0,4000.0,2,1,62000,62000,0
28,4,4,120000.0,0,1,520000,326000,194000
33,2,4,60000.0,0,1,327000,212000,115000
24,2,3,10000.0,2,1,151000,205000,-54000
37,4,3,3000.0,0,1,70000,102000,-32000
38,3,3,16500.0,1,1,71000,64000,7000
40,6,3,5000.0,1,1,194000,237000,-43000
44,5,1,0.0,0,1,60000,78000,-18000
40,4,4,12000.0,1,1,60000,43000,17000
23,4,3,127000.0,0,1,223000,195000,28000
29,4,4,25000.0,0,1,268000,160000,108000
25,2,0,10000.0,0,1,28000,25000,3000
34,5,0,20000.0,2,1,284000,232000,52000
18,2,4,75500.0,0,1,377000,266000,111000
25,3,5,310000.0,1,1,446000,382000,64000
45,8,4,18500.0,2,1,166000,236000,-70000
25,4,1,59000.0,0,1,74000,94000,-20000
37,4,4,22000.0,0,1,194000,305000,-111000
27,4,5,9000.0,1,0,371000,362000,9000
40,3,3,40000.0,1,1,371000,270000,101000
30,3,5,6000.0,1,1,134000,123000,11000
21,6,3,292000.0,1,1,900000,702000,198000
35,5,4,271000.0,0,0,446000,298000,148000
30,1,4,320500.0,1,1,927000,517000,410000
39,4,4,0.0,1,1,268000,171000,97000
33,5,4,90000.0,0,1,371000,261000,110000
48,3,5,20000.0,2,1,178000,235000,-57000
33,5,5,8000.0,1,1,356000,297000,59000
64,3,5,60000.0,0,1,238000,236000,2000
18,2,4,10000.0,2,1,140000,175000,-35000
40,3,0,10000.0,1,1,55000,67000,-12000
45,4,1,0.0,0,0,45000,53000,-8000
20,3,1,27000.0,0,1,180000,181000,-1000
32,2,4,41000.0,0,1,223000,143000,80000
28,4,3,49000.0,0,1,356000,275000,81000
32,4,4,50000.0,0,1,297000,222000,75000
25,5,0,0.0,0,1,268000,288000,-20000
29,5,4,168000.0,0,1,565000,337000,228000
18,4,2,1000.0,2,1,18000,15000,3000
44,2,1,0.0,0,1,45000,48000,-3000
40,1,5,6000.0,1,1,45000,66000,-21000
64,3,4,0.0,1,1,238000,163000,75000
34,3,4,50000.0,1,0,264000,360000,-96000
63,2,4,26000.0,2,1,198000,195000,3000
39,3,3,4000.0,0,1,74000,78000,-4000
28,2,0,0.0,1,1,30000,34000,-4000
32,4,4,53200.0,1,1,268000,339000,-71000
29,6,0,0.0,0,1,297000,282000,15000
45,1,4,10000.0,2,1,157000,100000,57000
29,1,5,9000.0,0,1,119000,113000,6000
65,4,5,62000.0,0,1,356000,290000,66000
65,1,2,44000.0,0,1,112000,130000,-18000
33,5,4,10000.0,2,1,208000,308000,-100000
58,4,4,180000.0,0,1,476000,354000,122000
36,5,1,20000.0,0,1,54000,50000,4000
46,3,3,77000.0,2,0,253000,204000,49000
20,2,4,0.0,1,1,52000,37000,15000
31,6,2,196000.0,1,1,431000,281000,150000
31,5,4,139008.0,1,1,282000,198000,84000
45,2,3,119000.0,1,1,416000,255000,161000
32,4,5,150000.0,1,1,268000,213000,55000
31,4,4,118000.0,0,1,104000,86000,18000
42,3,4,60000.0,0,1,356000,221000,135000
30,3,3,60000.0,1,1,178000,147000,31000
27,3,5,103000.0,1,1,208000,180000,28000
35,3,5,60300.0,0,1,374000,301000,73000
38,5,3,226000.0,1,1,641000,522000,119000
26,2,4,72300.0,1,1,99000,79000,20000
25,4,3,5000.0,0,1,119000,259000,-140000
40,6,3,2000.0,1,1,86000,111000,-25000
29,3,3,891500.0,0,1,1694000,605000,1089000
28,4,3,657500.0,1,1,1456000,714000,742000
62,3,2,2000.0,2,1,39000,38000,1000
68,4,4,174000.0,1,0,342000,493000,-151000
33,2,4,60850.0,0,0,327000,271000,56000
28,3,4,0.0,2,0,52000,76000,-24000
22,4,3,786300.0,1,0,1694000,945000,749000
18,5,3,401450.0,1,1,981000,635000,346000
47,3,4,11000.0,2,1,179000,214000,-35000
33,3,3,42000.0,2,1,280000,286000,-6000
32,4,5,60000.0,2,1,312000,263000,49000
50,4,2,174000.0,1,0,535000,430000,105000
26,2,4,26000.0,2,1,233000,259000,-26000
48,2,4,20000.0,2,1,219000,271000,-52000
23,4,4,72000.0,2,1,356000,275000,81000
27,4,0,20000.0,2,1,66000,66000,0
46,4,4,32000.0,2,1,317000,300000,17000
39,5,0,18200.0,2,1,273000,250000,23000
40,6,4,80000.0,1,1,297000,216000,81000
40,5,3,62000.0,1,1,356000,277000,79000
23,5,3,7000.0,1,1,260000,209000,51000
25,8,4,45000.0,0,1,268000,175000,93000
18,6,1,12000.0,0,1,26000,23000,3000
35,6,5,4000.0,1,1,148000,190000,-42000
26,2,4,54000.0,0,0,371000,275000,96000
22,4,4,49000.0,1,1,119000,98000,21000
36,4,4,78000.0,1,1,327000,244000,83000
39,2,4,1000.0,1,1,163000,102000,61000
31,2,5,9000.0,1,0,208000,192000,16000
49,4,4,20000.0,1,1,223000,164000,59000
26,3,4,30000.0,1,1,208000,139000,69000
27,2,4,0.0,1,1,148000,93000,55000
20,2,4,12000.0,0,0,60000,45000,15000
30,4,5,7000.0,2,1,238000,245000,-7000
47,2,4,35000.0,0,1,148000,95000,53000
45,4,2,8000.0,1,1,297000,251000,46000
48,3,5,8000.0,1,1,223000,162000,61000
34,5,4,0.0,1,1,297000,233000,64000
33,4,4,100000.0,1,1,297000,194000,103000
26,6,5,7000.0,2,1,297000,267000,30000
30,3,4,95000.0,0,1,119000,115000,4000
69,4,1,49000.0,0,1,178000,156000,22000
48,6,4,20000.0,1,1,238000,205000,33000
38,3,3,7000.0,1,1,178000,202000,-24000
47,2,4,50000.0,0,1,230000,142000,88000
50,5,5,17000.0,2,1,297000,276000,21000
36,4,5,9000.0,1,1,371000,321000,50000
38,8,4,25000.0,0,1,245000,221000,24000
49,3,4,30000.0,0,1,238000,152000,86000
39,1,4,0.0,0,1,145000,86000,59000
27,3,5,8000.0,0,1,253000,228000,25000
28,4,4,0.0,1,1,238000,157000,81000
24,4,4,100000.0,0,1,268000,184000,84000
62,3,5,8000.0,0,0,223000,189000,34000
32,3,4,25000.0,1,1,238000,162000,76000
40,4,4,52000.0,0,1,238000,148000,90000
40,4,4,68000.0,0,1,380000,273000,107000
25,3,4,214000.0,0,1,1041000,594000,447000
34,5,5,82000.0,0,1,268000,255000,13000
40,2,3,234000.0,0,1,446000,275000,171000
32,1,1,0.0,1,1,15000,13000,2000
62,4,4,42000.0,0,1,163000,221000,-58000
32,1,4,0.0,1,1,178000,114000,64000
45,5,5,6000.0,1,1,194000,223000,-29000
40,5,4,182000.0,0,1,268000,174000,94000
33,5,5,72000.0,0,1,342000,284000,58000
28,4,4,0.0,0,1,178000,195000,-17000
32,2,2,52000.0,0,1,89000,145000,-56000
38,1,5,9000.0,1,1,119000,113000,6000
18,5,5,6000.0,1,1,194000,262000,-68000
30,5,4,404000.0,0,1,535000,314000,221000
20,5,5,7000.0,1,0,268000,246000,22000
27,5,4,28200.0,2,1,208000,147000,61000
35,4,4,54000.0,1,1,327000,220000,107000
60,1,4,20000.0,2,0,231000,267000,-36000
33,4,4,25000.0,2,0,309000,224000,85000
56,2,4,50000.0,2,1,238000,360000,-122000
42,6,4,106000.0,2,1,280000,231000,49000
22,5,4,21000.0,2,1,208000,165000,43000
33,6,4,41000.0,2,1,232000,190000,42000
36,4,0,3100.0,2,1,194000,201000,-7000
32,2,4,70000.0,0,1,402000,260000,142000
33,2,5,6000.0,0,1,26000,39000,-13000
55,8,4,165500.0,1,1,541000,451000,90000
37,4,4,60200.0,2,1,247000,222000,25000
25,4,3,220000.0,1,1,356000,265000,91000
47,6,4,89000.0,0,1,312000,288000,24000
26,4,3,238000.0,1,0,497000,418000,79000
55,2,3,156000.0,1,1,223000,254000,-31000
40,5,3,216000.0,0,0,550000,422000,128000
31,5,4,187000.0,1,1,297000,264000,33000
25,6,4,90000.0,1,1,297000,275000,22000
28,3,4,310000.0,1,1,446000,263000,183000
64,5,4,118000.0,0,1,431000,428000,3000
43,4,4,378000.0,1,1,594000,320000,274000
36,2,4,120000.0,1,1,170000,102000,68000
38,2,4,225000.0,1,1,308000,211000,97000
36,3,4,214000.0,0,1,624000,444000,180000
26,2,0,7500.0,0,1,77000,74000,3000
51,1,3,15000.0,1,1,85000,78000,7000
26,6,4,90000.0,0,1,327000,228000,99000
33,5,4,100000.0,0,1,371000,237000,134000
60,5,4,402000.0,1,1,446000,267000,179000
24,4,4,260000.0,0,1,446000,344000,102000
31,4,1,0.0,0,1,60000,50000,10000
35,6,4,61000.0,0,1,446000,263000,183000
30,4,1,14800.0,0,1,54000,47000,7000
34,6,4,124000.0,0,1,402000,233000,169000
40,4,1,15000.0,0,1,54000,48000,6000
36,4,4,60000.0,0,1,386000,284000,102000
37,9,1,0.0,1,1,89000,104000,-15000
51,4,1,0.0,0,1,60000,59000,1000
35,5,4,30000.0,0,1,268000,199000,69000
40,5,4,80000.0,0,1,327000,198000,129000
35,4,1,0.0,0,1,148000,160000,-12000
36,2,4,15000.0,0,1,208000,142000,66000
34,4,1,0.0,0,1,148000,136000,12000
37,2,1,0.0,0,1,30000,28000,2000
29,4,1,5000.0,0,0,45000,54000,-9000
49,4,4,20000.0,0,1,234000,141000,93000
32,2,0,0.0,0,1,65000,59000,6000
33,6,4,90000.0,1,1,371000,246000,125000
26,5,0,15000.0,0,1,63000,82000,-19000
48,3,1,0.0,0,0,60000,60000,0
30,5,4,120000.0,0,1,380000,279000,101000
48,4,1,1000.0,0,1,178000,188000,-10000
34,5,4,25000.0,0,1,268000,156000,112000
44,5,0,0.0,0,1,269000,267000,2000
25,6,0,10000.0,0,1,268000,246000,22000
26,6,0,15000.0,0,1,223000,242000,-19000
33,6,4,20000.0,0,1,214000,128000,86000
39,2,0,0.0,0,1,89000,79000,10000
30,4,0,0.0,0,1,57000,50000,7000
20,6,3,345000.0,1,0,713000,474000,239000
33,2,0,0.0,0,1,36000,34000,2000
20,6,2,1000.0,0,1,49000,71000,-22000
30,4,1,0.0,0,1,45000,39000,6000
43,4,4,90000.0,1,1,371000,237000,134000
40,2,0,10000.0,0,1,28000,34000,-6000
32,3,1,0.0,0,1,45000,39000,6000
33,5,3,71000.0,1,1,566000,383000,183000
40,3,4,0.0,1,1,241000,145000,96000
65,4,5,5000.0,1,1,180000,174000,6000
45,3,4,1700.0,1,1,131000,89000,42000
35,4,3,14000.0,1,1,198000,194000,4000
32,2,4,10000.0,1,1,100000,81000,19000
35,3,4,20000.0,0,1,147000,85000,62000
52,3,2,3000.0,1,1,60000,52000,8000
32,4,5,10000.0,1,1,188000,182000,6000
40,6,1,1600.0,1,1,109000,88000,21000
45,3,5,20000.0,0,1,201000,188000,13000
40,4,1,5000.0,1,1,160000,132000,28000
32,6,5,15000.0,1,1,502000,365000,137000
25,4,3,20000.0,1,1,273000,209000,64000
32,5,4,5000.0,1,1,197000,136000,61000
36,6,5,30000.0,1,1,188000,179000,9000
44,3,4,132500.0,1,1,154000,100000,54000
38,3,3,20000.0,1,0,100000,122000,-22000
32,4,0,10000.0,1,0,80000,73000,7000
42,3,2,36000.0,2,1,121000,159000,-38000
25,4,4,0.0,1,0,241000,175000,66000
30,4,5,15000.0,0,1,165000,168000,-3000
37,6,5,2500.0,1,1,273000,231000,42000
33,5,4,0.0,1,1,301000,241000,60000
50,3,4,0.0,1,0,201000,169000,32000
32,4,2,1000.0,1,1,40000,49000,-9000
35,3,5,9000.0,1,1,180000,182000,-2000
31,3,4,3000.0,1,0,119000,84000,35000
22,4,3,4000.0,1,1,151000,137000,14000
35,3,2,3000.0,1,1,60000,95000,-35000
20,4,4,0.0,1,1,241000,154000,87000
25,5,4,0.0,1,1,160000,135000,25000
32,3,1,2000.0,1,1,144000,164000,-20000
60,5,2,2000.0,1,1,60000,60000,0
32,5,3,56000.0,1,1,397000,299000,98000
64,9,3,18500.0,1,1,253000,195000,58000
34,4,4,0.0,1,1,241000,170000,71000
18,4,2,2000.0,1,1,60000,63000,-3000
39,2,2,18000.0,2,1,140000,180000,-40000
41,4,2,2000.0,1,1,60000,53000,7000
30,5,4,20000.0,1,1,160000,161000,-1000
42,3,3,12000.0,1,0,148000,133000,15000
34,10,1,19000.0,1,1,333000,304000,29000
25,4,1,88000.0,1,1,185000,182000,3000
32,3,4,0.0,1,1,241000,161000,80000
30,5,0,10000.0,1,1,100000,88000,12000
64,5,4,0.0,0,1,241000,142000,99000
36,4,4,0.0,1,1,225000,151000,74000
48,4,2,5000.0,2,1,131000,146000,-15000
23,5,2,2000.0,1,0,60000,54000,6000
60,4,1,6000.0,1,1,244000,181000,63000
62,1,4,5000.0,0,0,65000,46000,19000
28,5,1,15000.0,1,1,100000,108000,-8000
33,2,4,0.0,1,1,144000,94000,50000
40,9,3,17200.0,1,1,235000,221000,14000
35,3,4,0.0,1,1,136000,117000,19000
32,4,4,0.0,1,1,261000,190000,71000
55,3,1,0.0,1,1,193000,169000,24000
18,4,5,15000.0,1,1,174000,173000,1000
70,5,3,24000.0,1,1,121000,171000,-50000
55,5,3,95000.0,1,1,602000,406000,196000
25,4,1,0.0,0,1,160000,150000,10000
31,4,2,7000.0,1,0,24000,17000,7000
26,3,3,7000.0,0,1,160000,130000,30000
25,4,2,2000.0,1,1,60000,80000,-20000
30,4,1,8000.0,1,1,218000,155000,63000
55,4,2,20000.0,1,1,261000,209000,52000
32,5,5,20000.0,0,1,133000,133000,0
22,5,1,10000.0,1,1,100000,105000,-5000
34,3,4,0.0,1,1,241000,154000,87000
34,3,4,12000.0,1,1,241000,149000,92000
25,5,3,405000.0,1,1,1105000,543000,562000
32,3,4,0.0,2,1,140000,112000,28000
32,4,1,8000.0,1,1,160000,183000,-23000
32,5,1,5000.0,1,1,164000,132000,32000
43,4,2,2000.0,1,1,60000,78000,-18000
35,5,4,12000.0,1,1,232000,152000,80000
32,2,4,20000.0,1,1,241000,170000,71000
65,6,4,0.0,1,1,241000,171000,70000
34,5,4,0.0,1,1,241000,147000,94000
40,4,4,5500.0,1,1,225000,130000,95000
32,4,1,0.0,0,1,241000,213000,28000
30,2,4,2000.0,1,1,109000,72000,37000
35,4,4,0.0,0,0,241000,162000,79000
40,2,4,0.0,0,0,201000,143000,58000
34,1,1,1200.0,2,1,48000,52000,-4000
36,4,1,5000.0,0,1,185000,181000,4000
20,5,5,5000.0,1,1,196000,178000,18000
90,5,4,6000.0,1,1,188000,118000,70000
19,4,4,0.0,0,1,241000,173000,68000
45,3,4,0.0,1,1,241000,157000,84000
37,2,1,4000.0,1,1,134000,131000,3000
32,4,4,4000.0,1,1,154000,103000,51000
38,4,4,0.0,0,1,241000,142000,99000
32,2,4,5000.0,0,1,128000,80000,48000
60,4,1,2400.0,0,1,183000,152000,31000
20,4,4,8000.0,0,1,173000,107000,66000
65,5,4,0.0,0,1,164000,136000,28000
46,5,5,17000.0,1,1,253000,254000,-1000
20,5,4,10000.0,0,1,241000,179000,62000
29,4,4,8500.0,0,1,195000,127000,68000
40,9,3,263500.0,1,1,747000,315000,432000
51,3,4,10000.0,0,1,201000,145000,56000
34,5,1,1900.0,0,0,160000,136000,24000
34,4,5,9300.0,0,1,264000,249000,15000
27,2,3,10100.0,0,0,241000,189000,52000
70,5,5,7700.0,0,1,221000,228000,-7000
45,3,3,4500.0,0,1,169000,160000,9000
27,4,1,3200.0,0,0,160000,181000,-21000
26,4,4,5300.0,0,1,176000,108000,68000
29,5,5,76500.0,0,1,301000,277000,24000
25,4,1,2800.0,0,1,140000,115000,25000
58,5,1,5000.0,0,0,160000,139000,21000
30,3,4,15000.0,1,1,241000,164000,77000
26,4,3,384000.0,1,1,964000,514000,450000
26,4,1,3000.0,0,1,140000,116000,24000
60,1,2,9000.0,0,1,72000,74000,-2000
21,4,3,28000.0,0,1,261000,199000,62000
21,6,3,288000.0,0,0,964000,548000,416000
30,5,5,11000.0,1,1,241000,194000,47000
28,4,2,18000.0,0,1,241000,164000,77000
29,3,1,7000.0,0,0,180000,197000,-17000
28,3,3,10000.0,0,1,221000,177000,44000
55,5,4,54700.0,1,1,241000,160000,81000
39,4,2,23500.0,0,1,482000,323000,159000
46,2,2,15000.0,1,0,121000,150000,-29000
27,4,1,3500.0,0,0,151000,175000,-24000
55,3,2,64500.0,1,1,542000,349000,193000
40,4,1,3250.0,0,1,140000,156000,-16000
28,4,4,10000.0,0,0,201000,125000,76000
34,6,4,4000.0,0,1,180000,135000,45000
40,5,3,7000.0,1,1,281000,206000,75000
28,5,2,27000.0,1,1,563000,421000,142000
20,3,3,8000.0,0,1,241000,207000,34000
30,3,4,4300.0,0,1,256000,148000,108000
38,2,3,21000.0,0,1,193000,173000,20000
22,4,3,28000.0,0,1,301000,241000,60000
18,5,2,8000.0,0,1,434000,306000,128000
18,4,1,0.0,0,1,180000,151000,29000
37,4,1,7000.0,0,1,221000,174000,47000
26,4,4,10000.0,0,1,201000,135000,66000
34,5,4,5800.0,0,1,226000,137000,89000
55,2,3,32500.0,1,1,193000,171000,22000
30,4,4,4200.0,0,1,213000,127000,86000
48,3,3,18300.0,0,1,196000,196000,0
42,10,1,27000.0,0,1,278000,208000,70000
70,3,5,32000.0,1,1,241000,203000,38000
65,5,4,10000.0,1,1,241000,145000,96000
30,5,4,1600.0,0,1,160000,119000,41000
73,2,1,0.0,0,1,36000,41000,-5000
28,2,4,2300.0,0,1,115000,69000,46000
21,2,1,0.0,0,0,48000,52000,-4000
31,2,4,4000.0,0,1,140000,90000,50000
33,3,4,59000.0,1,0,321000,212000,109000
22,3,4,500.0,0,1,133000,101000,32000
25,5,5,13500.0,1,1,241000,193000,48000
35,5,4,2100.0,0,1,183000,110000,73000
51,4,4,4800.0,0,1,241000,162000,79000
29,2,2,9200.0,0,0,140000,201000,-61000
45,5,1,6000.0,0,1,221000,167000,54000
20,4,3,277000.0,1,1,964000,419000,545000
30,6,1,3600.0,0,0,157000,132000,25000
20,3,2,9000.0,1,1,289000,233000,56000
36,9,1,0.0,0,1,221000,162000,59000
48,2,1,1800.0,0,1,131000,141000,-10000
35,3,4,14500.0,0,1,180000,134000,46000
29,3,3,27000.0,0,1,169000,84000,85000
24,2,3,44500.0,0,0,271000,196000,75000
43,4,5,25500.0,1,1,261000,243000,18000
28,6,3,127000.0,0,1,321000,242000,79000
30,3,5,9500.0,0,1,301000,242000,59000
32,3,4,10000.0,0,1,301000,197000,104000
35,5,1,1800.0,0,0,163000,133000,30000
65,10,3,51000.0,0,1,321000,258000,63000
48,4,4,55300.0,2,1,365000,243000,122000
30,3,3,52800.0,0,1,482000,364000,118000
26,5,4,104000.0,1,0,264000,157000,107000
25,6,3,610000.0,1,1,1438000,898000,540000
36,3,5,26000.0,1,1,385000,362000,23000
31,3,4,134500.0,1,1,702000,425000,277000
40,4,2,164000.0,1,1,391000,289000,102000
29,4,3,106000.0,1,1,763000,361000,402000
65,4,3,78000.0,1,1,259000,203000,56000
58,4,1,6000.0,1,1,118000,105000,13000
30,3,4,126000.0,1,0,723000,432000,291000
30,5,3,142500.0,1,1,563000,386000,177000
48,3,2,32000.0,1,1,100000,99000,1000
20,9,4,774600.0,1,1,1908000,772000,1136000
20,9,4,160000.0,1,1,916000,466000,450000
52,4,4,225600.0,1,1,1165000,681000,484000
62,4,1,17500.0,1,1,144000,137000,7000
30,4,3,160000.0,1,1,763000,496000,267000
42,4,4,238100.0,1,1,563000,345000,218000
27,4,4,95000.0,1,1,602000,379000,223000
28,9,4,100000.0,1,1,803000,537000,266000
70,5,3,116000.0,1,1,582000,442000,140000
20,4,3,94000.0,1,1,563000,534000,29000
38,11,4,200000.0,1,1,844000,482000,362000
42,8,3,150000.0,1,0,563000,388000,175000
36,4,5,465000.0,1,1,622000,354000,268000
38,3,3,10000.0,1,1,289000,230000,59000
22,3,5,173100.0,1,1,563000,310000,253000
50,4,5,50000.0,1,1,379000,374000,5000
31,3,5,9000.0,1,1,289000,271000,18000
43,5,5,48000.0,1,1,362000,445000,-83000
29,4,3,300000.0,1,0,803000,488000,315000
34,2,3,7000.0,2,1,289000,215000,74000
18,4,4,200000.0,1,1,904000,591000,313000
22,2,5,122000.0,1,1,482000,359000,123000
21,4,5,130000.0,1,1,602000,345000,257000
26,5,1,4000.0,1,1,84000,72000,12000
36,5,5,161500.0,1,1,803000,476000,327000
19,4,4,115000.0,1,1,502000,334000,168000
21,4,4,260100.0,1,1,702000,376000,326000
40,9,4,122500.0,1,1,763000,476000,287000
24,5,3,101500.0,1,1,602000,434000,168000
36,3,4,201000.0,1,1,803000,514000,289000
48,4,5,260000.0,1,1,702000,557000,145000
18,5,4,192000.0,1,1,763000,636000,127000
30,5,4,65000.0,1,1,482000,314000,168000
46,3,1,62200.0,1,1,100000,88000,12000
36,4,4,170000.0,1,1,582000,316000,266000
45,5,4,225000.0,1,1,763000,410000,353000
30,2,4,70000.0,1,1,482000,321000,161000
26,4,3,110000.0,1,0,602000,525000,77000
62,2,4,87000.0,1,1,518000,353000,165000
34,3,4,92500.0,1,1,362000,290000,72000
32,4,5,72500.0,1,0,442000,330000,112000
60,5,5,25000.0,1,1,702000,536000,166000
34,4,3,140000.0,1,1,602000,427000,175000
30,4,3,316550.0,1,1,924000,511000,413000
70,5,4,699000.0,1,1,1322000,745000,577000
20,3,3,112500.0,1,1,362000,306000,56000
43,5,4,151000.0,1,1,781000,495000,286000
26,4,0,50500.0,1,1,289000,245000,44000
30,8,4,160000.0,1,1,803000,494000,309000
26,4,1,30000.0,1,1,125000,129000,-4000
27,5,3,60000.0,1,1,434000,313000,121000
18,5,3,493000.0,1,1,702000,393000,309000
69,8,3,191645.0,1,1,803000,440000,363000
46,3,3,900500.0,1,1,1727000,942000,785000
30,4,2,6650.0,1,1,51000,61000,-10000
52,3,5,520000.0,1,1,1707000,1261000,446000
45,4,4,262000.0,1,1,803000,528000,275000
28,4,5,20000.0,1,1,434000,271000,163000
34,8,5,613645.0,1,0,1526000,935000,591000
30,4,3,37000.0,1,1,289000,230000,59000
27,5,3,44000.0,1,0,289000,231000,58000
32,4,1,24645.0,1,0,72000,70000,2000
65,4,1,55645.0,1,1,112000,117000,-5000
52,4,5,171500.0,1,1,1005000,791000,214000
40,1,5,290000.0,1,1,823000,684000,139000
37,5,5,20000.0,1,1,362000,339000,23000
30,5,1,15000.0,1,0,185000,171000,14000
38,2,4,105000.0,1,1,482000,270000,212000
46,4,5,120000.0,1,0,482000,335000,147000
25,2,3,23500.0,1,0,211000,192000,19000
34,4,5,88000.0,1,1,482000,328000,154000
48,5,5,165000.0,1,1,763000,614000,149000
35,3,3,23000.0,1,1,193000,280000,-87000
37,5,3,13000.0,1,1,241000,285000,-44000
40,4,1,20250.0,1,1,100000,89000,11000
30,2,2,217000.0,1,0,1406000,934000,472000
80,3,3,60000.0,1,1,362000,264000,98000
62,4,3,59000.0,1,1,339000,293000,46000
22,5,5,124500.0,1,1,321000,335000,-14000
54,3,2,267000.0,1,0,602000,462000,140000
33,2,4,115000.0,1,1,563000,334000,229000
62,3,3,228500.0,1,0,763000,536000,227000
24,2,1,69100.0,1,1,57000,49000,8000
32,4,3,336000.0,1,1,844000,551000,293000
28,2,5,566910.0,1,1,563000,448000,115000
29,2,3,65000.0,1,0,289000,232000,57000
37,4,1,12000.0,1,1,241000,198000,43000
35,2,1,43000.0,1,1,48000,50000,-2000
30,3,4,186000.0,1,0,1125000,451000,674000
40,5,3,12000.0,1,1,289000,309000,-20000
70,2,5,3000.0,1,1,241000,212000,29000
24,2,2,28500.0,1,1,362000,280000,82000
42,4,3,236600.0,1,1,502000,340000,162000
62,2,3,83000.0,1,1,531000,214000,317000
40,5,5,155100.0,1,1,482000,353000,129000
26,2,4,222500.0,1,0,1005000,686000,319000
44,4,3,57000.0,1,1,410000,319000,91000
30,2,5,40000.0,1,1,289000,276000,13000
27,4,3,360000.0,1,1,1005000,602000,403000
39,8,3,86000.0,1,0,602000,418000,184000
65,3,5,101000.0,1,1,683000,503000,180000
24,4,3,44000.0,1,0,362000,306000,56000
55,4,3,268000.0,1,1,622000,345000,277000
30,4,3,215000.0,1,1,683000,339000,344000
30,5,3,73000.0,1,1,452000,402000,50000
34,4,4,90000.0,1,1,702000,419000,283000
35,4,5,120000.0,1,1,702000,471000,231000
30,4,1,5500.0,1,0,60000,75000,-15000
31,5,4,203800.0,1,0,821000,514000,307000
50,3,4,138000.0,1,1,362000,249000,113000
39,2,3,555000.0,1,1,24000,23000,1000
60,5,3,200000.0,1,1,844000,523000,321000
18,5,5,242000.0,1,1,1707000,1347000,360000
65,6,1,105000.0,1,0,36000,30000,6000
21,4,4,45000.0,0,1,385000,255000,130000
56,5,4,258800.0,1,1,443000,328000,115000
65,10,4,0.0,1,1,118000,161000,-43000
30,1,2,5000.0,1,1,33000,37000,-4000
35,5,5,92400.0,0,1,108000,219000,-111000
32,2,2,68000.0,0,0,151000,151000,0
35,6,0,12700.0,0,1,47000,50000,-3000
75,5,1,3000.0,1,1,84000,87000,-3000
24,2,1,106650.0,0,1,78000,71000,7000
32,5,4,165000.0,1,1,441000,411000,30000
28,4,3,58000.0,1,0,337000,431000,-94000
75,6,4,12000.0,1,0,193000,129000,64000
46,4,3,1000.0,0,0,1000,1000,0
55,5,4,357000.0,1,1,398000,664000,-266000
32,6,1,8500.0,1,1,163000,158000,5000
25,3,3,30000.0,1,1,145000,297000,-152000
55,10,4,6600.0,1,0,211000,174000,37000
35,3,4,0.0,1,0,67000,56000,11000
30,3,0,40000.0,0,0,90000,81000,9000
38,2,1,11000.0,1,1,96000,93000,3000
24,9,1,95000.0,1,1,134000,148000,-14000
23,13,3,30000.0,1,1,296000,325000,-29000
38,3,5,60000.0,1,0,72000,105000,-33000
35,4,1,0.0,1,1,99000,116000,-17000
39,5,3,1000.0,0,0,2000,3000,-1000
25,2,0,15000.0,0,1,60000,54000,6000
26,6,1,7500.0,2,0,96000,103000,-7000
37,4,1,78200.0,1,1,122000,115000,7000
70,2,4,0.0,1,1,102000,85000,17000
23,9,5,21000.0,0,1,72000,114000,-42000
51,6,4,29000.0,1,0,127000,86000,41000
38,5,4,5000.0,1,1,84000,68000,16000
32,3,2,6000.0,1,0,25000,19000,6000
27,9,4,14300.0,1,0,19000,31000,-12000
29,4,1,3700.0,1,1,165000,182000,-17000
32,3,2,15553.0,1,0,54000,66000,-12000
45,4,4,20000.0,1,1,297000,322000,-25000
47,2,5,45000.0,0,1,337000,311000,26000
57,4,4,15000.0,1,0,118000,114000,4000
29,9,4,4900.0,1,1,169000,197000,-28000
47,3,2,29000.0,0,0,72000,94000,-22000
26,5,0,3800.0,1,1,118000,97000,21000
30,4,3,1000.0,0,1,39000,36000,3000
30,3,3,49000.0,1,1,103000,145000,-42000
18,6,1,78000.0,0,1,102000,105000,-3000
58,4,3,19000.0,1,1,96000,79000,17000
32,9,1,25735.0,1,1,19000,18000,1000
52,4,4,7000.0,0,1,180000,207000,-27000
30,3,3,56000.0,1,1,210000,128000,82000
50,1,3,17000.0,1,1,96000,191000,-95000
47,3,4,90000.0,1,1,361000,243000,118000
30,4,4,0.0,0,1,72000,48000,24000
40,3,4,13500.0,1,1,84000,59000,25000
28,3,1,5000.0,1,1,80000,94000,-14000
30,11,4,31000.0,1,1,36000,33000,3000
58,4,2,1000.0,0,1,4000,4000,0
33,5,0,0.0,0,1,19000,20000,-1000
30,4,4,51000.0,1,0,180000,188000,-8000
49,4,4,7000.0,1,1,19000,17000,2000
24,5,4,0.0,1,1,145000,137000,8000
40,3,0,0.0,1,1,72000,74000,-2000
68,4,2,27000.0,2,1,169000,176000,-7000
37,4,4,2000.0,1,1,24000,19000,5000
20,5,5,29000.0,1,1,446000,401000,45000
21,5,4,100000.0,1,1,268000,192000,76000
26,6,3,7000.0,0,0,164000,150000,14000
25,5,0,2000.0,0,1,115000,106000,9000
50,6,4,19900.0,0,1,42000,55000,-13000
29,5,4,0.0,0,0,60000,90000,-30000
25,3,4,10000.0,1,1,285000,297000,-12000
49,5,3,1000.0,0,1,42000,58000,-16000
51,4,2,9000.0,1,1,379000,545000,-166000
28,5,3,13000.0,1,1,84000,57000,27000
55,4,3,4000.0,0,1,94000,94000,0
41,12,1,0.0,1,1,33000,28000,5000
28,5,3,1000.0,0,1,6000,6000,0
47,5,4,154500.0,1,1,48000,40000,8000
35,3,4,15000.0,1,1,121000,193000,-72000
55,4,3,35000.0,0,1,143000,150000,-7000
25,16,4,0.0,1,1,229000,246000,-17000
30,11,4,1000.0,1,1,118000,169000,-51000
57,1,5,9000.0,1,1,96000,89000,7000
28,9,1,22400.0,2,1,171000,191000,-20000
70,3,4,88000.0,1,1,110000,144000,-34000
20,6,4,9500.0,1,1,33000,23000,10000
31,5,5,5000.0,1,0,182000,269000,-87000
77,10,0,141000.0,0,1,180000,159000,21000
35,4,4,64000.0,1,1,301000,263000,38000
23,3,2,7000.0,1,1,156000,247000,-91000
35,6,1,8000.0,1,1,74000,72000,2000
40,3,2,49000.0,0,1,301000,230000,71000
34,4,4,4200.0,1,0,169000,167000,2000
35,4,1,12000.0,1,0,116000,125000,-9000
31,10,5,0.0,0,0,54000,68000,-14000
23,6,2,39000.0,1,1,169000,261000,-92000
27,3,2,7000.0,1,1,174000,215000,-41000
27,3,3,6000.0,0,1,127000,117000,10000
35,4,0,19000.0,1,1,127000,124000,3000
34,6,4,8745.0,1,1,159000,205000,-46000
36,3,1,2000.0,2,1,15000,13000,2000
37,4,3,5000.0,1,1,180000,184000,-4000
45,2,3,14000.0,1,1,122000,115000,7000
35,3,3,1048000.0,1,1,603000,392000,211000
32,4,4,280000.0,1,1,303000,181000,122000
68,6,4,52000.0,1,1,160000,233000,-73000
40,3,3,11440.0,0,1,101000,120000,-19000
65,5,4,53000.0,1,0,313000,226000,87000
45,4,4,45000.0,0,1,260000,154000,106000
34,6,5,29000.0,0,1,217000,179000,38000
24,6,3,3000.0,0,0,117000,395000,-278000
30,5,3,9300.0,0,1,151000,135000,16000
35,9,4,31000.0,1,1,26000,15000,11000
52,4,4,0.0,0,1,155000,108000,47000
21,6,4,30000.0,2,1,90000,76000,14000
38,5,0,17000.0,1,1,87000,73000,14000
36,3,3,258000.0,1,1,241000,246000,-5000
45,5,4,25000.0,1,1,297000,384000,-87000
24,5,1,0.0,0,1,145000,138000,7000
52,6,4,80000.0,1,1,459000,325000,134000
40,6,1,12000.0,0,1,78000,68000,10000
36,4,5,5000.0,1,1,45000,71000,-26000
40,6,4,250000.0,1,1,470000,335000,135000
23,3,3,3200.0,1,1,48000,53000,-5000
21,5,1,5700.0,1,0,132000,118000,14000
28,5,1,16000.0,1,1,74000,91000,-17000
55,5,1,14000.0,1,1,122000,119000,3000
47,5,1,10500.0,1,1,84000,96000,-12000
32,6,1,5000.0,1,1,84000,78000,6000
22,4,0,5600.0,1,1,169000,144000,25000
43,2,4,261000.0,1,0,289000,212000,77000
28,6,3,1800.0,1,0,49000,64000,-15000
20,6,3,1600.0,1,0,48000,54000,-6000
36,3,1,17000.0,1,1,92000,101000,-9000
26,2,4,36000.0,1,1,127000,132000,-5000
27,4,4,39000.0,1,0,145000,156000,-11000
38,5,3,1200.0,1,1,29000,35000,-6000
40,4,4,255000.0,1,1,361000,306000,55000
28,3,4,30000.0,1,1,96000,154000,-58000
32,4,5,86000.0,1,1,186000,297000,-111000
38,10,1,4950.0,1,1,277000,225000,52000
55,4,4,0.0,1,1,96000,140000,-44000
38,5,5,12500.0,1,1,145000,235000,-90000
26,10,3,50000.0,1,0,248000,233000,15000
28,11,5,55000.0,1,0,320000,293000,27000
26,5,5,4000.0,1,1,79000,120000,-41000
35,5,5,34000.0,1,1,137000,180000,-43000
32,4,1,0.0,1,1,104000,128000,-24000
20,5,5,5000.0,1,1,180000,182000,-2000
70,6,4,40000.0,1,1,207000,206000,1000
24,4,3,258000.0,1,1,783000,508000,275000
32,5,4,162000.0,1,0,301000,431000,-130000
48,4,3,156000.0,1,1,205000,153000,52000
36,9,4,296000.0,1,1,531000,385000,146000
23,4,1,56000.0,1,0,157000,165000,-8000
58,10,5,1000.0,1,0,66000,86000,-20000
34,4,4,140000.0,1,1,421000,294000,127000
46,9,3,30000.0,1,1,111000,216000,-105000
60,5,1,18000.0,1,1,96000,113000,-17000
65,5,4,0.0,1,1,205000,152000,53000
20,4,5,4000.0,1,1,96000,126000,-30000
20,2,5,1000.0,0,1,1000,1000,0
40,6,4,0.0,0,1,48000,37000,11000
32,4,4,0.0,0,1,72000,66000,6000
45,2,4,0.0,0,1,123000,77000,46000
23,2,4,0.0,0,1,15000,11000,4000
22,4,4,0.0,0,1,48000,43000,5000
40,4,4,0.0,0,1,15000,11000,4000
40,4,1,0.0,0,1,12000,10000,2000
30,9,4,0.0,0,1,72000,90000,-18000
35,6,4,0.0,1,1,24000,19000,5000
85,6,2,1000.0,0,1,10000,9000,1000
39,4,3,1000.0,0,1,12000,13000,-1000
80,6,5,1000.0,0,1,7000,14000,-7000
30,9,4,0.0,1,1,180000,144000,36000
35,13,3,1000.0,1,1,48000,53000,-5000
27,4,3,1000.0,0,1,2000,2000,0
42,5,4,5000.0,0,1,30000,21000,9000
52,5,3,3000.0,0,1,99000,89000,10000
28,6,4,82000.0,1,1,482000,326000,156000
28,3,5,1000.0,0,1,6000,11000,-5000
30,9,4,0.0,0,1,104000,73000,31000
30,9,4,0.0,0,1,193000,129000,64000
18,4,3,1000.0,0,0,6000,7000,-1000
26,2,5,1000.0,0,1,19000,30000,-11000
25,10,2,3000.0,1,1,174000,146000,28000
29,2,1,0.0,0,1,1000,1000,0
21,4,0,0.0,1,1,48000,44000,4000
18,4,2,24000.0,1,1,48000,46000,2000
50,4,1,12000.0,0,1,24000,24000,0
21,5,1,5000.0,0,1,139000,113000,26000
32,3,4,0.0,0,1,108000,71000,37000
36,6,4,5000.0,0,1,199000,132000,67000
45,4,3,60000.0,1,1,590000,328000,262000
46,4,3,11000.0,0,1,115000,126000,-11000
35,4,0,0.0,0,1,96000,99000,-3000
28,4,0,0.0,0,1,60000,57000,3000
31,5,3,3000.0,0,1,96000,49000,47000
48,4,3,1000.0,0,1,2000,2000,0
34,5,2,1000.0,0,1,9000,7000,2000
31,6,4,0.0,2,0,36000,29000,7000
64,6,5,1000.0,0,1,12000,23000,-11000
54,6,3,12000.0,2,1,133000,133000,0
30,3,5,51000.0,0,0,1000,2000,-1000
65,4,3,1000.0,0,1,7000,8000,-1000
60,6,4,0.0,0,1,19000,16000,3000
50,6,4,0.0,0,1,19000,17000,2000
28,2,2,1000.0,0,1,15000,16000,-1000
24,5,4,0.0,0,1,36000,29000,7000
26,4,3,6000.0,0,1,183000,185000,-2000
60,6,3,2000.0,0,1,72000,127000,-55000
35,5,1,0.0,0,1,12000,13000,-1000
24,5,3,1000.0,0,0,15000,15000,0
45,6,4,0.0,0,1,133000,83000,50000
60,6,0,0.0,0,0,84000,77000,7000
19,4,4,0.0,0,1,36000,30000,6000
48,5,3,2000.0,0,1,80000,107000,-27000
60,4,4,2000.0,1,1,48000,35000,13000
28,9,0,2000.0,0,1,199000,242000,-43000
24,2,5,5000.0,1,1,72000,109000,-37000
40,6,1,3000.0,1,1,180000,182000,-2000
28,6,4,5000.0,0,1,89000,111000,-22000
22,5,4,20000.0,0,1,87000,70000,17000
24,12,4,0.0,1,1,72000,47000,25000
38,11,3,54500.0,1,1,326000,234000,92000
20,11,4,15600.0,1,1,72000,61000,11000
42,5,3,33000.0,1,1,133000,116000,17000
19,6,3,8000.0,0,1,121000,107000,14000
60,4,3,8000.0,1,1,84000,82000,2000
30,5,3,50000.0,1,1,217000,192000,25000
49,5,3,15200.0,1,1,271000,212000,59000
19,5,0,500.0,0,1,24000,23000,1000
24,5,5,6000.0,1,1,36000,46000,-10000
31,6,5,8000.0,0,0,250000,180000,70000
37,2,4,0.0,1,1,19000,14000,5000
32,9,5,52000.0,1,1,145000,229000,-84000
33,5,3,351000.0,1,1,151000,135000,16000
27,6,3,3000.0,1,1,128000,121000,7000
56,4,0,30500.0,1,1,72000,75000,-3000
22,9,4,48000.0,1,1,78000,82000,-4000
26,5,3,11000.0,0,0,121000,120000,1000
28,3,3,42000.0,1,1,96000,88000,8000
26,5,3,32000.0,0,1,96000,93000,3000
42,5,3,41000.0,1,0,134000,121000,13000
45,9,0,49000.0,1,1,102000,99000,3000
23,5,0,0.0,1,1,30000,30000,0
24,5,3,31000.0,0,0,96000,89000,7000
32,13,2,1000.0,0,0,60000,48000,12000
40,3,4,0.0,0,1,241000,157000,84000
62,5,0,0.0,0,1,30000,48000,-18000
26,11,3,2000.0,0,0,133000,80000,53000
33,2,3,4000.0,1,1,45000,102000,-57000
33,6,2,1000.0,1,1,54000,54000,0
67,6,3,5000.0,1,1,217000,153000,64000
42,5,3,3000.0,0,1,36000,45000,-9000
42,4,3,113000.0,1,1,253000,159000,94000
50,4,4,0.0,0,1,15000,12000,3000
55,4,3,70000.0,1,1,410000,417000,-7000
43,4,2,11000.0,0,1,102000,115000,-13000
65,6,4,200000.0,1,1,904000,483000,421000
63,6,3,521000.0,1,1,205000,132000,73000
26,2,2,27000.0,1,1,12000,14000,-2000
42,6,0,4000.0,0,1,115000,124000,-9000
30,6,0,22000.0,1,1,60000,70000,-10000
45,4,1,5000.0,1,1,36000,39000,-3000
50,5,3,251000.0,1,1,235000,236000,-1000
18,4,3,15000.0,0,1,66000,148000,-82000
32,4,0,7000.0,1,1,72000,77000,-5000
40,4,3,10000.0,1,1,36000,158000,-122000
24,4,0,2000.0,0,1,54000,47000,7000
65,4,2,8000.0,0,1,75000,78000,-3000
41,4,3,60000.0,1,1,193000,225000,-32000
68,3,2,9000.0,1,1,75000,67000,8000
45,3,3,372000.0,1,1,723000,582000,141000
40,3,4,27000.0,1,1,180000,163000,17000
20,12,3,212100.0,1,0,607000,585000,22000
32,10,3,27000.0,1,1,217000,186000,31000
62,4,3,64000.0,1,1,412000,477000,-65000
34,9,3,6000.0,0,1,268000,306000,-38000
25,6,4,20000.0,1,1,211000,352000,-141000
23,3,3,60000.0,1,0,385000,565000,-180000
38,6,1,4000.0,1,1,82000,99000,-17000
22,6,4,0.0,0,1,128000,76000,52000
26,9,3,42000.0,1,1,277000,312000,-35000
24,11,4,0.0,1,0,180000,110000,70000
32,5,4,138000.0,1,1,573000,404000,169000
18,5,3,90000.0,1,1,301000,1048000,-747000
18,5,4,21000.0,1,1,53000,37000,16000
25,3,4,24000.0,1,1,60000,99000,-39000
59,4,4,0.0,1,1,132000,208000,-76000
45,4,0,54300.0,0,1,90000,78000,12000
30,4,4,16000.0,1,0,180000,151000,29000
32,5,3,2000.0,1,1,65000,34000,31000
23,5,3,60000.0,1,0,163000,277000,-114000
28,6,1,6100.0,0,1,48000,61000,-13000
40,4,0,54000.0,0,1,102000,93000,9000
62,4,4,0.0,1,1,58000,34000,24000
27,3,4,62000.0,1,1,265000,242000,23000
65,5,0,9500.0,1,1,54000,54000,0
24,2,2,8000.0,1,1,130000,152000,-22000
60,5,1,100000.0,0,1,48000,53000,-5000
35,2,0,2500.0,1,1,29000,27000,2000
33,4,4,0.0,0,1,90000,108000,-18000
55,6,4,45000.0,0,1,110000,86000,24000
22,4,1,45000.0,0,1,78000,85000,-7000
29,4,3,7000.0,1,1,203000,182000,21000
30,10,1,1000.0,0,1,90000,116000,-26000
28,4,3,4000.0,1,1,104000,325000,-221000
28,5,2,5000.0,1,0,180000,190000,-10000
27,6,2,1000.0,1,0,43000,38000,5000
42,6,0,3500.0,0,1,78000,87000,-9000
55,4,4,0.0,1,1,101000,95000,6000
40,4,4,75000.0,0,1,127000,135000,-8000
60,5,3,5000.0,1,1,174000,235000,-61000
32,4,4,70000.0,1,1,421000,299000,122000
40,2,4,32000.0,0,1,111000,128000,-17000
70,3,4,125000.0,1,1,301000,187000,114000
65,5,4,52000.0,1,1,180000,138000,42000
75,4,4,60000.0,0,1,145000,180000,-35000
25,4,4,0.0,0,1,145000,112000,33000
42,4,2,1000.0,0,1,15000,11000,4000
42,5,3,35000.0,0,1,116000,168000,-52000
57,9,5,1000.0,0,1,15000,38000,-23000
35,3,4,0.0,0,1,60000,66000,-6000
22,2,2,1000.0,1,1,4000,4000,0
24,4,3,1000.0,1,1,3000,4000,-1000
47,5,5,2000.0,0,1,66000,65000,1000
70,5,5,62000.0,0,1,96000,239000,-143000
30,11,4,130000.0,0,1,279000,189000,90000
33,4,4,60000.0,0,1,261000,446000,-185000
18,5,4,60000.0,0,1,142000,100000,42000
33,5,4,180000.0,0,1,241000,141000,100000
26,3,3,70000.0,0,1,145000,252000,-107000
50,4,4,460000.0,0,1,482000,293000,189000
32,5,0,2000.0,0,0,133000,158000,-25000
70,6,4,158000.0,0,0,163000,122000,41000
32,9,4,205000.0,0,1,448000,280000,168000
20,6,3,145000.0,0,1,265000,425000,-160000
30,4,4,67000.0,0,1,260000,172000,88000
30,5,4,194500.0,0,1,180000,150000,30000
38,4,0,3250.0,0,1,102000,100000,2000
20,2,2,129000.0,1,1,241000,172000,69000
43,10,4,255000.0,0,1,368000,271000,97000
22,4,4,104500.0,0,1,90000,67000,23000
19,2,4,20000.0,0,1,180000,117000,63000
29,4,3,415000.0,1,1,675000,329000,346000
45,5,4,13000.0,1,0,72000,46000,26000
50,4,5,45000.0,0,1,380000,314000,66000
68,3,5,23000.0,0,1,277000,266000,11000
36,4,3,20000.0,1,1,96000,201000,-105000
21,4,4,13000.0,0,1,96000,106000,-10000
42,3,2,28000.0,1,0,87000,110000,-23000
26,5,4,156000.0,1,0,197000,169000,28000
57,4,2,51000.0,0,1,165000,261000,-96000
42,4,5,22000.0,0,1,277000,226000,51000
32,5,2,38000.0,1,1,84000,77000,7000
35,4,2,6000.0,1,0,157000,195000,-38000
30,3,4,46000.0,0,1,205000,134000,71000
54,4,1,24000.0,0,0,41000,55000,-14000
36,9,2,5000.0,1,1,327000,547000,-220000
37,6,4,20000.0,1,1,58000,53000,5000
40,5,4,7500.0,1,1,36000,22000,14000
29,9,3,90000.0,1,1,305000,322000,-17000
33,9,4,12000.0,1,1,22000,14000,8000
54,2,4,4500.0,1,1,19000,15000,4000
48,4,4,6500.0,1,1,33000,24000,9000
40,4,2,45000.0,1,0,147000,145000,2000
39,3,2,211000.0,1,1,169000,151000,18000
22,5,2,85000.0,1,0,160000,152000,8000
20,3,2,32000.0,1,0,42000,39000,3000
41,6,2,38000.0,1,0,113000,137000,-24000
31,10,2,49000.0,1,0,240000,567000,-327000
38,6,5,48000.0,0,1,337000,346000,-9000
42,4,2,152000.0,1,1,348000,766000,-418000
36,3,4,142000.0,0,1,217000,133000,84000
18,5,2,4000.0,0,1,145000,183000,-38000
30,4,2,171000.0,1,1,163000,180000,-17000
48,10,2,14000.0,0,1,221000,185000,36000
37,12,4,110000.0,1,1,329000,530000,-201000
35,10,2,177000.0,0,1,266000,382000,-116000
25,5,2,3000.0,0,1,108000,113000,-5000
54,9,5,50000.0,1,1,121000,164000,-43000
40,6,4,335000.0,1,1,327000,202000,125000
39,3,0,7500.0,1,1,40000,42000,-2000
40,11,3,60000.0,0,1,369000,266000,103000
32,5,4,8000.0,1,1,72000,121000,-49000
30,6,0,97000.0,1,1,30000,28000,2000
25,6,4,8000.0,0,1,145000,87000,58000
18,5,4,10000.0,0,1,108000,150000,-42000
25,4,4,319000.0,1,1,374000,485000,-111000
18,6,4,45000.0,0,1,170000,112000,58000
71,4,2,11000.0,0,0,127000,194000,-67000
39,10,2,4500.0,1,1,39000,38000,1000
20,6,4,19000.0,0,1,72000,58000,14000
25,10,2,36000.0,1,1,49000,44000,5000
28,6,2,24000.0,0,1,238000,359000,-121000
21,9,2,5000.0,1,0,37000,36000,1000
30,5,2,9000.0,0,0,139000,210000,-71000
51,4,2,31000.0,0,0,169000,190000,-21000
65,6,3,23000.0,0,1,78000,84000,-6000
35,6,1,43000.0,0,1,122000,114000,8000
30,2,3,230000.0,0,1,315000,259000,56000
42,6,1,55000.0,0,1,97000,114000,-17000
43,3,4,58000.0,0,1,139000,145000,-6000
33,5,3,412000.0,2,1,318000,246000,72000
30,4,1,5000.0,0,1,122000,124000,-2000
22,4,4,0.0,1,1,147000,144000,3000
37,5,1,58000.0,0,1,103000,102000,1000
60,6,1,91000.0,1,1,122000,124000,-2000
21,4,3,17000.0,1,1,119000,185000,-66000
40,6,1,58000.0,1,1,110000,119000,-9000
60,10,1,7000.0,1,1,96000,90000,6000
43,6,1,13000.0,1,1,72000,69000,3000
23,9,3,145000.0,1,1,171000,277000,-106000
26,5,4,140000.0,1,0,326000,226000,100000
30,9,5,340000.0,1,1,301000,301000,0
45,10,1,43000.0,1,1,177000,178000,-1000
43,5,1,63000.0,1,1,98000,108000,-10000
57,3,1,0.0,1,1,36000,34000,2000
23,13,3,5000.0,1,1,133000,292000,-159000
58,11,1,13000.0,1,1,102000,103000,-1000
20,3,2,4000.0,1,1,48000,37000,11000
23,5,2,44000.0,1,0,578000,640000,-62000
52,9,5,5500.0,1,1,301000,281000,20000
29,9,3,2500.0,0,1,72000,176000,-104000
32,2,1,62000.0,1,1,22000,22000,0
26,9,2,7000.0,1,1,542000,402000,140000
32,3,4,30000.0,1,1,289000,194000,95000
39,2,4,55000.0,1,0,344000,257000,87000
25,4,4,71000.0,1,1,443000,322000,121000
44,1,2,10000.0,1,1,145000,190000,-45000
35,3,0,0.0,1,1,29000,37000,-8000
38,1,4,0.0,1,1,145000,123000,22000
45,3,4,0.0,1,1,217000,144000,73000
25,6,4,0.0,1,1,289000,183000,106000
55,3,2,37000.0,1,1,289000,200000,89000
45,3,0,0.0,1,1,36000,32000,4000
33,4,4,16500.0,1,0,218000,229000,-11000
50,4,4,68000.0,1,1,369000,326000,43000
28,3,4,10000.0,0,1,74000,62000,12000
36,4,3,290000.0,1,1,301000,239000,62000
65,4,1,25000.0,0,1,133000,155000,-22000
33,4,1,40000.0,2,1,121000,134000,-13000
21,5,1,51000.0,1,1,193000,204000,-11000
28,5,4,5000.0,0,0,176000,162000,14000
18,6,4,80000.0,1,0,298000,280000,18000
37,3,4,72000.0,1,1,434000,304000,130000
39,5,4,0.0,0,1,224000,217000,7000
46,9,4,64000.0,1,1,361000,349000,12000
57,6,4,0.0,1,1,217000,204000,13000
31,2,5,1000.0,1,0,122000,143000,-21000
33,5,4,2000.0,1,1,145000,167000,-22000
55,9,0,94000.0,1,0,241000,212000,29000
48,3,5,55000.0,1,0,145000,149000,-4000
45,6,1,12000.0,1,1,96000,78000,18000
81,2,4,60600.0,1,0,159000,130000,29000
32,5,3,814400.0,1,1,867000,376000,491000
34,6,3,126900.0,1,1,531000,361000,170000
29,5,0,72300.0,0,1,99000,93000,6000
28,4,1,1.0,0,1,58000,55000,3000
37,5,4,94000.0,1,1,193000,235000,-42000
70,4,4,290000.0,1,1,363000,238000,125000
34,3,4,172000.0,1,1,344000,236000,108000
32,6,5,31500.0,1,1,152000,178000,-26000
55,4,5,45000.0,1,1,154000,185000,-31000
50,4,4,105900.0,1,1,286000,263000,23000
58,3,1,3000.0,1,1,37000,34000,3000
38,5,4,20006.0,1,1,184000,199000,-15000
19,3,4,91500.0,1,1,202000,207000,-5000
30,6,0,1200.0,1,1,195000,189000,6000
23,3,4,160500.0,1,1,309000,279000,30000
47,1,2,112000.0,1,1,96000,106000,-10000
26,3,3,140000.0,1,1,182000,163000,19000
26,6,3,150800.0,1,1,159000,162000,-3000
38,4,1,9000.0,1,1,47000,46000,1000
29,9,4,799200.0,1,1,1060000,646000,414000
38,5,4,100000.0,1,1,361000,243000,118000
40,6,4,180000.0,1,1,417000,287000,130000
33,2,4,0.0,1,1,130000,189000,-59000
30,11,4,423000.0,1,0,629000,420000,209000
35,6,4,70000.0,1,1,439000,345000,94000
28,5,0,43000.0,1,0,108000,91000,17000
48,4,5,170000.0,1,0,121000,172000,-51000
35,2,1,14500.0,1,1,22000,27000,-5000
32,3,1,19000.0,1,1,41000,43000,-2000
32,4,1,7000.0,1,1,78000,98000,-20000
35,2,4,71500.0,1,1,180000,154000,26000
48,5,5,17000.0,1,1,250000,218000,32000
30,11,1,36000.0,1,0,115000,137000,-22000
45,5,4,207000.0,1,1,251000,242000,9000
50,5,4,50000.0,0,1,180000,193000,-13000
45,6,4,550000.0,1,1,542000,285000,257000
36,10,5,78000.0,1,1,180000,214000,-34000
58,6,3,40000.0,1,1,120000,181000,-61000
28,5,3,160000.0,1,1,145000,155000,-10000
37,4,5,89000.0,1,1,108000,143000,-35000
32,4,1,136500.0,0,1,158000,127000,31000
28,6,1,149000.0,1,1,149000,141000,8000
35,5,1,45000.0,1,1,121000,139000,-18000
60,6,1,194000.0,1,1,134000,135000,-1000
56,11,1,155000.0,1,1,150000,153000,-3000
30,4,5,80000.0,1,1,217000,243000,-26000
48,2,2,37000.0,1,1,72000,104000,-32000
22,6,1,54000.0,1,1,145000,155000,-10000
34,9,1,73000.0,1,1,162000,187000,-25000
38,10,1,32000.0,1,1,121000,126000,-5000
25,2,2,40000.0,1,1,72000,103000,-31000
58,4,3,14000.0,1,1,180000,184000,-4000
60,3,4,59000.0,0,1,96000,136000,-40000
25,4,0,45000.0,1,1,48000,49000,-1000
20,5,1,0.0,1,1,99000,120000,-21000
35,4,4,180000.0,1,1,706000,366000,340000
45,1,4,0.0,1,1,152000,218000,-66000
25,3,4,72000.0,1,1,441000,452000,-11000
25,3,4,178000.0,1,1,603000,335000,268000
55,3,4,194000.0,1,1,844000,558000,286000
46,3,5,9000.0,1,0,289000,314000,-25000
26,3,3,316400.0,1,0,988000,477000,511000
40,4,2,6000.0,1,1,180000,241000,-61000
40,1,4,110000.0,1,1,217000,187000,30000
37,1,2,710000.0,1,1,636000,465000,171000
45,1,4,0.0,1,1,147000,199000,-52000
52,5,2,38000.0,1,1,337000,455000,-118000
29,2,4,15000.0,1,1,118000,198000,-80000
47,9,2,79000.0,1,0,819000,783000,36000
26,9,1,35000.0,1,1,289000,307000,-18000
26,11,4,90000.0,1,1,363000,468000,-105000
34,6,4,60000.0,1,1,260000,190000,70000
55,4,2,2000.0,0,1,48000,51000,-3000
19,9,5,1000.0,0,1,48000,79000,-31000
37,3,5,3000.0,0,1,54000,55000,-1000
38,5,4,0.0,1,1,96000,85000,11000
23,5,3,6000.0,0,1,217000,360000,-143000
27,1,4,0.0,0,1,78000,130000,-52000
55,4,4,0.0,1,1,78000,56000,22000
40,6,4,0.0,0,1,137000,113000,24000
35,4,4,0.0,1,1,247000,192000,55000
23,3,4,3000.0,0,1,94000,75000,19000
41,4,3,3000.0,1,1,78000,79000,-1000
40,4,4,31000.0,1,1,229000,287000,-58000
19,3,3,59000.0,1,1,193000,114000,79000
35,4,3,3000.0,1,1,72000,78000,-6000
36,5,3,2000.0,1,1,72000,96000,-24000
37,4,4,0.0,1,0,72000,66000,6000
22,3,5,2000.0,1,1,36000,66000,-30000
36,6,4,0.0,1,1,48000,38000,10000
41,4,3,2000.0,1,1,54000,54000,0
50,6,3,20000.0,1,1,188000,378000,-190000
37,10,4,90000.0,1,1,359000,259000,100000
26,5,4,25000.0,1,0,180000,127000,53000
40,9,3,265000.0,1,1,639000,218000,421000
60,11,1,20000.0,1,1,238000,169000,69000
40,4,0,54000.0,1,1,96000,103000,-7000
19,4,0,12000.0,1,1,180000,173000,7000
35,4,5,56000.0,1,1,108000,135000,-27000
45,9,1,0.0,1,1,180000,206000,-26000
25,5,0,29000.0,1,1,60000,57000,3000
70,5,0,6500.0,1,1,48000,49000,-1000
45,9,4,30000.0,1,1,253000,159000,94000
43,5,0,3000.0,1,1,96000,105000,-9000
50,9,1,9500.0,1,1,136000,177000,-41000
42,11,0,31000.0,1,1,350000,308000,42000
36,5,5,17000.0,0,1,48000,79000,-31000
30,10,5,21000.0,0,1,48000,121000,-73000
29,4,4,0.0,1,1,24000,20000,4000
79,6,4,40000.0,1,1,176000,302000,-126000
30,11,4,5000.0,1,0,133000,179000,-46000
45,4,5,7500.0,0,1,54000,110000,-56000
18,4,4,49500.0,1,0,145000,115000,30000
26,4,3,177000.0,1,1,217000,337000,-120000
52,10,4,80000.0,1,1,205000,150000,55000
19,5,3,35000.0,1,1,149000,118000,31000
55,4,3,8000.0,1,0,262000,244000,18000
35,4,3,13000.0,0,1,102000,249000,-147000
30,5,1,0.0,1,1,101000,90000,11000
26,4,3,3000.0,1,1,78000,108000,-30000
20,4,5,0.0,1,1,78000,84000,-6000
22,5,4,0.0,0,1,48000,33000,15000
26,5,5,10500.0,1,1,30000,33000,-3000
45,4,5,8000.0,1,1,277000,247000,30000
22,13,0,0.0,1,1,96000,95000,1000
37,4,0,4000.0,0,1,24000,29000,-5000
36,9,5,16000.0,1,1,36000,54000,-18000
51,9,5,29200.0,1,1,236000,171000,65000
52,9,4,11500.0,0,1,36000,24000,12000
25,6,1,21000.0,0,0,58000,55000,3000
26,6,4,20000.0,1,1,36000,24000,12000
42,10,3,3900.0,0,1,31000,35000,-4000
44,6,4,20000.0,1,1,243000,379000,-136000
35,10,0,49032.0,1,1,313000,279000,34000
62,4,3,50000.0,0,1,260000,248000,12000
52,4,1,15000.0,1,1,180000,182000,-2000
18,9,4,10000.0,0,1,54000,32000,22000
55,5,5,280000.0,1,1,180000,327000,-147000
30,4,5,10000.0,1,1,48000,47000,1000
28,9,1,15000.0,0,1,182000,174000,8000
26,1,0,5000.0,1,1,16000,20000,-4000
30,4,3,20000.0,1,1,145000,330000,-185000
18,5,1,25000.0,1,1,60000,73000,-13000
40,6,1,3500.0,0,1,51000,42000,9000
32,4,3,17000.0,1,1,36000,35000,1000
60,13,4,0.0,0,1,145000,139000,6000
45,5,2,3000.0,1,1,96000,159000,-63000
62,1,5,10000.0,0,1,60000,87000,-27000
65,6,3,1000.0,2,1,12000,32000,-20000
55,9,2,1000.0,0,1,36000,29000,7000
35,11,2,3000.0,2,1,180000,212000,-32000
50,3,4,0.0,2,1,96000,83000,13000
35,6,5,29000.0,0,1,145000,201000,-56000
42,6,3,30000.0,0,1,193000,430000,-237000
36,5,3,4000.0,0,1,145000,225000,-80000
49,4,3,83000.0,0,1,87000,197000,-110000
40,4,4,17000.0,0,1,48000,38000,10000
45,4,4,29000.0,1,1,72000,61000,11000
54,3,4,16200.0,0,1,48000,30000,18000
55,5,4,35000.0,1,1,195000,331000,-136000
43,6,3,2000.0,1,1,72000,110000,-38000
42,5,3,30000.0,1,1,241000,225000,16000
45,9,1,45000.0,1,1,301000,225000,76000
28,5,4,8000.0,1,1,60000,42000,18000
60,10,4,180000.0,1,1,253000,290000,-37000
40,6,4,25000.0,1,1,241000,361000,-120000
42,4,4,50000.0,1,1,181000,246000,-65000
32,5,4,25000.0,1,1,236000,268000,-32000
50,6,4,50000.0,1,1,241000,361000,-120000
23,2,4,6200.0,1,0,108000,133000,-25000
38,9,4,7200.0,1,1,229000,189000,40000
20,5,4,9130.0,1,1,217000,214000,3000
35,10,4,9700.0,1,1,163000,197000,-34000
46,5,4,7000.0,1,1,121000,85000,36000
18,6,0,7500.0,1,1,157000,137000,20000
24,9,4,6000.0,1,1,169000,193000,-24000
50,9,4,8000.0,1,1,229000,210000,19000
34,4,5,8935.0,1,1,301000,273000,28000
26,5,4,0.0,1,0,118000,78000,40000
33,12,4,15000.0,1,1,145000,177000,-32000
26,6,4,0.0,1,0,145000,145000,0
30,10,4,5000.0,1,1,145000,140000,5000
37,6,4,0.0,1,1,157000,106000,51000
26,6,4,25000.0,1,1,145000,130000,15000
35,10,4,5000.0,1,1,145000,98000,47000
34,10,4,35000.0,1,0,151000,162000,-11000
30,9,4,24800.0,1,1,151000,154000,-3000
25,9,4,5000.0,1,1,152000,143000,9000
42,6,4,0.0,1,1,145000,154000,-9000
34,9,4,14000.0,1,1,151000,154000,-3000
50,6,4,13000.0,1,1,139000,151000,-12000
20,2,4,3500.0,1,1,118000,91000,27000
75,5,4,10500.0,1,1,118000,133000,-15000
43,2,0,3500.0,1,1,84000,73000,11000
30,6,4,3500.0,1,1,163000,104000,59000
40,6,4,6000.0,1,1,163000,138000,25000
28,6,4,0.0,1,1,175000,136000,39000
21,9,4,40000.0,1,1,175000,121000,54000
30,9,4,8500.0,1,1,163000,148000,15000
26,6,4,8500.0,1,1,163000,148000,15000
52,2,4,0.0,1,1,118000,103000,15000
33,6,2,21500.0,1,1,398000,546000,-148000
42,3,4,4000.0,1,1,169000,268000,-99000
40,5,4,6600.0,1,1,157000,210000,-53000
26,6,4,5000.0,1,1,193000,191000,2000
50,9,4,8630.0,1,1,253000,193000,60000
30,4,3,6500.0,1,1,108000,162000,-54000
27,1,3,10500.0,1,1,115000,139000,-24000
55,5,1,5000.0,1,1,116000,145000,-29000
24,3,4,0.0,1,1,78000,101000,-23000
58,9,4,0.0,1,1,111000,87000,24000
32,5,4,0.0,1,1,111000,131000,-20000
55,3,4,25000.0,1,1,118000,134000,-16000
26,2,4,0.0,1,1,90000,99000,-9000
32,6,4,0.0,1,1,115000,119000,-4000
45,6,4,30000.0,1,1,145000,126000,19000
18,2,4,0.0,1,1,72000,93000,-21000
45,6,4,0.0,1,1,118000,125000,-7000
45,6,4,0.0,1,1,118000,148000,-30000
35,12,4,9400.0,1,1,157000,232000,-75000
50,13,4,58200.0,1,1,365000,262000,103000
44,16,1,9200.0,1,1,352000,291000,61000
20,6,4,56400.0,1,1,145000,225000,-80000
38,13,5,7800.0,1,1,350000,299000,51000
53,5,4,5700.0,1,1,145000,170000,-25000
38,6,4,10200.0,1,1,193000,168000,25000
29,4,4,0.0,1,1,119000,137000,-18000
27,9,4,0.0,1,1,145000,155000,-10000
36,5,4,0.0,1,1,180000,143000,37000
32,6,4,30000.0,1,1,90000,80000,10000
23,10,4,81500.0,1,1,102000,136000,-34000
35,9,4,0.0,1,1,118000,157000,-39000
32,10,4,18000.0,1,0,229000,183000,46000
24,6,4,30000.0,1,1,116000,160000,-44000
26,6,4,0.0,1,1,72000,49000,23000
46,9,4,9930.0,1,1,193000,212000,-19000
47,1,4,4200.0,1,1,84000,125000,-41000
50,6,4,5000.0,1,1,217000,241000,-24000
40,5,4,4700.0,1,1,180000,181000,-1000
27,6,4,5800.0,1,1,217000,224000,-7000
34,5,0,5000.0,1,1,157000,152000,5000
75,9,4,6700.0,1,1,271000,261000,10000
40,14,1,31200.0,1,1,283000,315000,-32000
33,9,4,4700.0,1,1,118000,191000,-73000
35,4,4,4935.0,1,1,259000,236000,23000
40,5,1,3500.0,1,1,115000,138000,-23000
48,5,1,7400.0,1,1,145000,166000,-21000
40,9,4,15200.0,1,1,231000,162000,69000
44,5,4,4600.0,1,1,145000,142000,3000
36,4,4,4435.0,1,1,180000,142000,38000
62,10,5,5350.0,1,1,180000,217000,-37000
40,9,4,2050.0,1,1,163000,144000,19000
22,5,4,3700.0,1,1,205000,150000,55000
40,6,4,5250.0,1,1,118000,103000,15000
22,1,2,6000.0,0,1,19000,23000,-4000
35,5,4,6300.0,1,1,297000,177000,120000
20,2,5,4520.0,1,1,87000,107000,-20000
26,10,4,5200.0,1,0,96000,64000,32000
23,5,4,32849.0,1,1,186000,129000,57000
62,5,4,2050.0,1,1,193000,149000,44000
42,4,1,3700.0,1,1,48000,44000,4000
24,6,1,5000.0,1,1,34000,37000,-3000
45,4,4,500.0,1,1,157000,174000,-17000
28,11,4,3000.0,0,1,229000,198000,31000
21,9,4,2000.0,1,0,166000,245000,-79000
35,5,4,1000.0,1,1,118000,85000,33000
36,6,1,5000.0,1,1,133000,145000,-12000
55,9,4,4830.0,1,1,157000,234000,-77000
85,1,4,6500.0,1,1,133000,118000,15000
21,6,1,5000.0,1,1,169000,175000,-6000
28,3,4,32000.0,1,1,133000,218000,-85000
34,5,1,10330.0,1,1,145000,134000,11000
23,4,4,9530.0,1,1,193000,218000,-25000
35,6,5,5000.0,1,0,108000,136000,-28000
55,4,4,0.0,1,0,160000,111000,49000
19,4,4,0.0,1,1,108000,93000,15000
31,5,4,0.0,1,1,209000,246000,-37000
24,2,4,0.0,1,0,104000,61000,43000
50,5,5,28800.0,1,1,82000,159000,-77000
22,5,1,10000.0,1,0,54000,47000,7000
32,13,5,22100.0,1,1,54000,127000,-73000
20,5,5,23000.0,1,0,87000,148000,-61000
54,4,1,1700.0,1,1,39000,40000,-1000
18,6,1,23608.0,1,1,145000,133000,12000
29,6,5,8000.0,1,0,90000,94000,-4000
32,6,5,4200.0,1,1,81000,125000,-44000
44,3,2,27500.0,1,1,90000,142000,-52000
31,2,2,67000.0,1,0,102000,113000,-11000
24,2,5,16000.0,1,1,30000,61000,-31000
30,3,5,8000.0,1,1,54000,70000,-16000
18,3,5,14000.0,1,1,24000,28000,-4000
28,3,2,5000.0,1,1,19000,15000,4000
56,4,2,30700.0,1,1,78000,90000,-12000
65,4,2,29500.0,1,1,24000,25000,-1000
55,4,3,251000.0,1,1,326000,630000,-304000
31,4,3,19000.0,1,1,63000,51000,12000
27,3,4,0.0,1,1,54000,55000,-1000
36,5,4,0.0,1,1,104000,151000,-47000
18,6,4,0.0,1,1,115000,83000,32000
35,5,4,0.0,1,1,195000,182000,13000
30,3,4,0.0,1,1,199000,150000,49000
60,4,4,0.0,1,1,211000,135000,76000
24,2,3,4000.0,1,1,54000,116000,-62000
40,5,5,100000.0,1,1,512000,346000,166000
18,10,4,30000.0,0,1,217000,168000,49000
32,12,4,15000.0,1,0,265000,411000,-146000
65,6,4,20000.0,1,0,180000,155000,25000
28,11,4,3300.0,2,1,169000,155000,14000
25,12,0,0.0,0,1,243000,268000,-25000
19,5,4,15000.0,1,1,193000,299000,-106000
50,6,1,0.0,0,1,145000,179000,-34000
62,9,0,0.0,0,1,180000,166000,14000
27,5,3,73000.0,1,1,482000,335000,147000
21,2,1,0.0,0,1,74000,86000,-12000
45,5,2,22000.0,1,1,11000,11000,0
18,1,1,39000.0,2,1,29000,28000,1000
20,6,3,25000.0,2,1,170000,441000,-271000
29,4,3,26000.0,2,0,193000,435000,-242000
25,13,0,12700.0,1,1,78000,81000,-3000
53,5,0,11700.0,1,1,19000,20000,-1000
30,4,1,3700.0,1,0,145000,128000,17000
38,9,3,329000.0,1,1,578000,510000,68000
29,2,3,210300.0,1,0,867000,1404000,-537000
30,5,3,107000.0,1,1,145000,369000,-224000
30,5,2,46800.0,1,0,84000,124000,-40000
60,3,3,320000.0,1,1,242000,207000,35000
38,9,0,0.0,1,1,51000,47000,4000
60,9,4,0.0,1,1,154000,108000,46000
36,2,3,10000.0,1,1,54000,117000,-63000
60,1,4,0.0,1,1,66000,49000,17000
29,5,4,0.0,1,1,139000,128000,11000
28,6,4,5000.0,1,1,96000,87000,9000
25,3,4,0.0,1,1,118000,81000,37000
23,4,4,5000.0,1,0,54000,67000,-13000
34,4,4,5000.0,1,1,54000,62000,-8000
32,1,4,0.0,1,1,54000,41000,13000
22,9,3,26500.0,1,1,78000,314000,-236000
30,4,0,5000.0,1,1,54000,63000,-9000
40,4,4,58123.0,1,1,123000,84000,39000
70,10,4,9700.0,1,1,109000,72000,37000
21,6,3,8500.0,1,1,87000,231000,-144000
22,11,2,19500.0,1,1,30000,24000,6000
30,9,4,89347.0,1,1,172000,161000,11000
30,6,0,5000.0,0,0,72000,72000,0
40,6,4,6400.0,1,1,154000,231000,-77000
32,5,4,1500.0,1,1,78000,56000,22000
27,3,4,0.0,0,0,12000,11000,1000
47,6,1,35000.0,2,1,171000,219000,-48000
32,5,4,70000.0,1,1,217000,187000,30000
49,10,1,11000.0,1,1,157000,126000,31000
35,6,1,20000.0,1,1,78000,91000,-13000
34,5,4,0.0,1,1,217000,181000,36000
21,5,0,2900.0,1,1,133000,120000,13000
18,3,0,7000.0,1,1,48000,42000,6000
56,2,5,83000.0,0,1,614000,437000,177000
26,2,2,38000.0,0,0,145000,138000,7000
20,4,3,55000.0,0,1,121000,132000,-11000
44,4,4,249000.0,1,1,434000,287000,147000
30,9,5,262000.0,1,1,482000,356000,126000
18,2,5,101000.0,0,1,24000,49000,-25000
35,2,4,0.0,1,1,36000,26000,10000
18,4,5,9000.0,0,1,452000,324000,128000
31,3,5,11400.0,0,1,335000,298000,37000
45,5,4,0.0,0,1,216000,259000,-43000
27,4,5,100000.0,0,0,336000,319000,17000
52,3,5,45000.0,0,1,294000,284000,10000
49,3,3,68000.0,0,1,462000,295000,167000
65,4,3,89000.0,0,1,593000,531000,62000
60,4,5,60000.0,0,1,266000,286000,-20000
23,4,5,54000.0,0,1,373000,303000,70000
26,6,3,305000.0,0,1,783000,334000,449000
35,4,5,37000.0,0,1,306000,303000,3000
70,4,4,35000.0,0,1,276000,239000,37000
43,3,5,25000.0,0,1,382000,347000,35000
60,5,3,70000.0,0,1,529000,343000,186000
35,3,4,61000.0,0,1,291000,197000,94000
45,2,4,25000.0,0,0,100000,85000,15000
29,3,3,165000.0,0,1,332000,199000,133000
26,3,3,157000.0,0,0,622000,364000,258000
32,8,3,67000.0,0,1,306000,193000,113000
28,3,5,175000.0,0,1,502000,345000,157000
50,5,3,66250.0,0,1,520000,391000,129000
30,4,3,320000.0,0,1,723000,492000,231000
27,4,3,44644.0,0,1,165000,247000,-82000
20,6,3,260000.0,0,1,827000,416000,411000
43,4,5,90000.0,0,0,761000,549000,212000
35,3,5,170000.0,0,1,596000,462000,134000
50,3,3,71000.0,0,1,555000,367000,188000
28,3,4,0.0,0,1,240000,236000,4000
19,4,3,59450.0,0,1,505000,321000,184000
19,2,5,22000.0,0,1,228000,210000,18000
45,3,3,73000.0,0,1,431000,316000,115000
26,3,5,7000.0,0,1,154000,227000,-73000
25,3,5,9000.0,0,1,306000,320000,-14000
40,4,5,8000.0,0,1,308000,288000,20000
32,3,3,261500.0,0,1,954000,656000,298000
28,3,5,25000.0,0,0,193000,233000,-40000
22,4,3,7000.0,0,0,196000,245000,-49000
35,3,5,53500.0,0,1,266000,263000,3000
45,1,2,19500.0,0,0,492000,340000,152000
65,4,5,245000.0,0,1,1011000,567000,444000
44,4,5,0.0,0,1,206000,206000,0
31,5,5,7000.0,0,1,247000,244000,3000
40,6,3,237500.0,0,0,823000,438000,385000
30,6,3,35000.0,0,1,251000,256000,-5000
25,5,3,103500.0,0,1,362000,273000,89000
20,4,2,58240.0,0,0,343000,241000,102000
44,3,3,134000.0,0,1,301000,237000,64000
32,3,1,0.0,0,1,75000,95000,-20000
44,4,5,32000.0,0,1,203000,185000,18000
29,4,3,34280.0,0,0,185000,184000,1000
24,5,3,315300.0,0,0,924000,444000,480000
27,5,5,100000.0,0,1,482000,321000,161000
42,3,5,160000.0,0,1,624000,458000,166000
22,5,1,32000.0,0,1,279000,238000,41000
38,4,4,0.0,1,1,191000,204000,-13000
55,2,2,85000.0,0,0,480000,378000,102000
56,3,3,600000.0,0,1,1446000,696000,750000
41,5,2,84000.0,0,1,575000,419000,156000
26,1,4,0.0,0,1,84000,78000,6000
35,5,4,0.0,1,0,80000,138000,-58000
30,4,5,25000.0,1,1,371000,457000,-86000
37,3,4,0.0,2,1,106000,64000,42000
23,5,4,33000.0,1,1,237000,201000,36000
30,5,5,26500.0,1,1,556000,345000,211000
20,6,4,68000.0,1,1,402000,238000,164000
32,4,1,17000.0,1,1,145000,149000,-4000
37,3,3,330000.0,1,1,904000,537000,367000
45,2,3,107450.0,0,1,154000,232000,-78000
36,4,2,47000.0,1,1,454000,325000,129000
38,2,0,1000.0,1,1,100000,92000,8000
38,5,4,139300.0,1,1,563000,363000,200000
28,3,4,955000.0,1,0,1305000,754000,551000
27,1,0,0.0,2,1,25000,23000,2000
35,4,0,0.0,1,1,124000,107000,17000
40,2,3,325000.0,1,1,702000,459000,243000
29,5,4,295000.0,1,1,520000,430000,90000
35,4,3,200000.0,1,1,903000,559000,344000
22,6,2,162500.0,1,1,1486000,1134000,352000
30,5,2,89000.0,1,1,563000,470000,93000
32,4,3,12900.0,0,1,281000,242000,39000
42,3,3,40000.0,2,1,282000,185000,97000
42,5,4,115000.0,1,1,1005000,602000,403000
39,5,1,11000.0,0,1,163000,146000,17000
20,3,2,8000.0,1,1,251000,429000,-178000
26,4,4,0.0,1,1,160000,102000,58000
55,5,3,105000.0,1,1,312000,405000,-93000
21,4,4,0.0,1,1,201000,138000,63000
30,5,3,255000.0,1,0,1054000,662000,392000
32,1,1,8000.0,1,0,84000,82000,2000
28,4,4,0.0,1,0,241000,152000,89000
40,15,1,5150.0,0,1,241000,226000,15000
26,4,4,22000.0,1,1,148000,144000,4000
28,4,3,50000.0,1,1,520000,608000,-88000
38,5,4,1020000.0,1,1,2410000,1037000,1373000
25,4,4,20000.0,0,1,51000,34000,17000
22,4,3,210000.0,1,1,723000,472000,251000
60,3,0,2000.0,2,1,160000,157000,3000
28,2,3,50000.0,1,1,371000,434000,-63000
20,4,4,222000.0,1,1,1125000,656000,469000
36,4,3,611500.0,1,1,910000,500000,410000
33,5,4,210000.0,0,1,317000,355000,-38000
34,6,4,0.0,0,0,160000,105000,55000
28,3,3,2000.0,2,1,38000,126000,-88000
48,5,3,390000.0,1,1,1005000,595000,410000
39,4,4,0.0,1,1,80000,62000,18000
60,3,1,50000.0,2,1,119000,137000,-18000
42,8,3,24650.0,0,1,301000,291000,10000
30,3,3,176000.0,1,1,663000,325000,338000
25,4,3,176000.0,1,1,663000,357000,306000
39,5,3,427500.0,1,1,702000,403000,299000
31,4,4,150000.0,1,0,803000,502000,301000
37,8,4,213000.0,2,1,284000,220000,64000
45,4,5,23500.0,1,1,249000,278000,-29000
33,4,4,56186.0,1,1,241000,143000,98000
42,2,4,195000.0,0,1,295000,199000,96000
18,5,1,32000.0,1,1,301000,290000,11000
30,9,5,3800.0,0,0,140000,198000,-58000
25,4,3,45000.0,1,1,434000,347000,87000
75,5,1,30000.0,0,0,157000,147000,10000
38,2,1,45000.0,1,1,72000,58000,14000
60,4,3,420000.0,1,1,702000,557000,145000
35,4,5,64000.0,1,1,416000,322000,94000
25,4,3,305000.0,1,1,702000,390000,312000
36,3,5,235588.0,1,0,563000,305000,258000
32,5,5,25000.0,1,1,402000,377000,25000
21,2,3,2150000.0,1,0,5021000,1626000,3395000
24,2,2,80000.0,0,1,462000,321000,141000
28,4,4,0.0,1,0,281000,189000,92000
46,3,5,110050.0,1,1,160000,246000,-86000
19,8,4,0.0,1,1,226000,158000,68000
20,4,4,0.0,0,1,221000,140000,81000
26,2,3,100000.0,1,0,321000,199000,122000
40,5,5,236000.0,1,1,904000,543000,361000
32,4,4,0.0,1,1,241000,140000,101000
35,4,0,0.0,2,1,219000,207000,12000
60,1,3,15000.0,0,1,261000,212000,49000
45,3,3,40000.0,1,1,379000,307000,72000
29,3,2,13000.0,1,0,251000,192000,59000
52,12,3,59000.0,1,1,362000,416000,-54000
32,3,4,168000.0,1,1,535000,341000,194000
54,4,1,0.0,2,1,198000,181000,17000
50,5,0,2000.0,2,1,178000,170000,8000
19,4,4,70000.0,0,1,180000,299000,-119000
25,5,2,7000.0,1,1,251000,192000,59000
42,5,3,328000.0,1,1,1005000,480000,525000
43,5,4,41000.0,1,1,338000,215000,123000
48,3,2,2000.0,0,1,35000,43000,-8000
30,5,2,82000.0,2,0,312000,221000,91000
54,5,4,66000.0,1,1,362000,219000,143000
56,4,4,410000.0,1,1,770000,431000,339000
22,5,1,20000.0,1,1,180000,157000,23000
28,3,1,0.0,1,0,133000,109000,24000
38,9,0,2000.0,0,1,53000,74000,-21000
35,2,3,55000.0,2,0,178000,166000,12000
40,3,3,362500.0,1,1,753000,493000,260000
28,3,0,1000.0,1,1,125000,105000,20000
28,4,3,130000.0,1,1,502000,473000,29000
35,4,4,0.0,0,1,113000,94000,19000
22,14,5,12000.0,0,1,208000,219000,-11000
35,5,3,198000.0,1,1,602000,455000,147000
40,5,4,0.0,0,0,201000,135000,66000
34,5,4,0.0,1,1,80000,138000,-58000
45,4,1,16000.0,2,1,93000,102000,-9000
26,8,1,55000.0,0,1,201000,181000,20000
27,5,5,5000.0,1,0,177000,397000,-220000
40,2,1,43000.0,1,1,43000,52000,-9000
54,3,3,50000.0,1,1,301000,196000,105000
22,4,1,15000.0,0,1,163000,152000,11000
26,4,5,677500.0,1,1,1506000,876000,630000
21,5,4,10000.0,1,1,100000,129000,-29000
42,3,4,3000.0,1,1,221000,138000,83000
35,5,3,198000.0,1,1,903000,551000,352000
48,2,5,210000.0,1,1,702000,495000,207000
32,3,5,320000.0,1,1,803000,479000,324000
30,5,4,0.0,0,1,241000,167000,74000
54,3,4,0.0,2,1,30000,23000,7000
24,3,5,105000.0,1,1,371000,335000,36000
18,5,4,66000.0,1,1,362000,249000,113000
28,6,4,83000.0,1,0,502000,611000,-109000
21,4,3,16000.0,0,1,104000,204000,-100000
35,5,4,0.0,1,1,100000,96000,4000
45,3,0,0.0,1,1,160000,140000,20000
30,2,5,9000.0,2,1,194000,174000,20000
32,3,4,0.0,2,0,241000,160000,81000
42,3,4,0.0,2,1,221000,144000,77000
40,6,3,860000.0,1,1,1627000,607000,1020000
30,2,4,0.0,0,1,221000,135000,86000
36,6,4,76200.0,1,0,505000,329000,176000
52,13,4,3000.0,1,1,148000,241000,-93000
45,5,4,137000.0,1,1,563000,441000,122000
28,6,3,8000.0,1,1,414000,402000,12000
24,1,4,0.0,1,1,160000,95000,65000
50,4,3,330000.0,1,1,602000,523000,79000
65,5,4,91500.0,1,1,376000,218000,158000
22,1,3,40000.0,1,0,362000,301000,61000
50,4,4,0.0,2,1,100000,63000,37000
35,2,3,75000.0,1,1,301000,234000,67000
28,3,0,10000.0,0,1,75000,78000,-3000
20,2,0,0.0,1,1,80000,73000,7000
18,5,0,5000.0,1,1,113000,107000,6000
34,5,3,264000.0,1,1,1080000,599000,481000
52,4,2,9000.0,1,1,452000,328000,124000
35,3,4,6000.0,2,0,141000,112000,29000
24,4,3,500000.0,1,0,1041000,425000,616000
49,6,5,5000.0,0,1,180000,166000,14000
92,5,4,0.0,1,0,66000,56000,10000
37,8,1,18000.0,1,1,95000,103000,-8000
25,10,1,6500.0,2,1,90000,92000,-2000
48,5,4,35000.0,1,1,338000,217000,121000
50,3,4,0.0,2,1,65000,41000,24000
35,3,5,15000.0,1,1,100000,99000,1000
19,2,3,360000.0,1,1,702000,395000,307000
22,4,3,22000.0,0,0,241000,185000,56000
20,3,3,85000.0,1,0,381000,305000,76000
34,9,4,412500.0,1,0,967000,589000,378000
22,4,1,2700.0,1,1,276000,333000,-57000
28,4,2,60000.0,1,1,66000,56000,10000
55,4,3,334500.0,1,1,803000,451000,352000
34,5,4,10000.0,1,1,100000,88000,12000
60,10,1,14000.0,2,1,148000,136000,12000
23,3,3,40000.0,1,1,371000,416000,-45000
20,5,3,213000.0,1,1,1054000,633000,421000
68,4,2,10000.0,1,1,563000,451000,112000
60,8,4,135000.0,2,1,465000,291000,174000
36,4,4,6000.0,1,1,110000,86000,24000
33,5,4,45000.0,1,1,301000,190000,111000
60,3,2,3000.0,0,1,58000,51000,7000
35,3,0,0.0,1,1,51000,49000,2000
68,3,0,10000.0,1,1,139000,128000,11000
29,9,3,98000.0,2,1,602000,452000,150000
47,4,4,0.0,0,1,160000,121000,39000
37,4,0,0.0,1,1,160000,159000,1000
55,4,4,10000.0,2,1,194000,127000,67000
30,2,1,195800.0,0,1,60000,73000,-13000
55,5,4,0.0,0,1,100000,65000,35000
23,3,3,41000.0,1,0,381000,289000,92000
31,4,1,3000.0,1,1,83000,80000,3000
48,2,4,0.0,2,1,144000,168000,-24000
29,3,0,10000.0,1,1,65000,65000,0
45,6,4,11000.0,2,1,225000,349000,-124000
32,5,3,92000.0,1,1,602000,510000,92000
28,6,1,9000.0,0,1,183000,150000,33000
28,4,0,20000.0,1,1,176000,155000,21000
32,5,1,6900.0,0,1,190000,164000,26000
70,3,3,0.0,1,1,251000,208000,43000
31,3,3,39000.0,1,1,362000,300000,62000
70,3,2,55000.0,1,1,251000,230000,21000
29,4,3,232500.0,1,1,550000,386000,164000
18,5,3,1000.0,1,1,40000,36000,4000
70,4,4,37000.0,1,1,121000,134000,-13000
38,5,5,9000.0,1,1,446000,276000,170000
38,8,3,4195000.0,1,1,4117000,1957000,2160000
30,3,4,0.0,2,0,71000,44000,27000
40,8,3,56512.0,1,1,362000,301000,61000
46,5,3,175000.0,1,1,663000,424000,239000
72,3,4,22508.0,0,0,241000,170000,71000
60,3,0,0.0,2,1,95000,101000,-6000
34,4,4,0.0,1,1,301000,202000,99000
26,4,1,21000.0,1,0,89000,78000,11000
43,8,1,21500.0,1,1,160000,145000,15000
35,3,1,51000.0,1,0,54000,49000,5000
36,5,4,0.0,1,1,139000,90000,49000
49,3,4,10000.0,1,1,241000,151000,90000
50,5,4,98000.0,1,1,381000,233000,148000
46,4,4,135000.0,1,1,502000,383000,119000
31,4,5,265000.0,1,1,669000,443000,226000
25,5,5,38000.0,1,1,351000,252000,99000
45,5,1,4800.0,1,1,140000,183000,-43000
32,4,4,0.0,1,0,113000,76000,37000
28,3,4,160000.0,1,1,535000,295000,240000
21,5,4,0.0,1,1,89000,65000,24000
38,4,3,375000.0,1,1,763000,381000,382000
26,5,3,405000.0,1,1,663000,461000,202000
32,4,0,25500.0,1,1,63000,59000,4000
55,4,5,107000.0,1,1,208000,204000,4000
26,3,5,9000.0,1,0,362000,317000,45000
21,2,3,1042007.0,1,1,502000,322000,180000
28,4,4,0.0,2,0,160000,93000,67000
30,4,1,64000.0,1,1,115000,133000,-18000
44,4,4,10000.0,0,1,180000,116000,64000
42,3,3,1458000.0,1,0,2410000,1543000,867000
45,4,1,4000.0,1,0,89000,80000,9000
34,3,3,311700.0,1,1,702000,239000,463000
60,6,4,65000.0,1,1,366000,297000,69000
23,4,5,235000.0,0,1,396000,336000,60000
50,2,4,7300.0,0,1,128000,115000,13000
60,9,4,71000.0,0,1,510000,318000,192000
41,2,5,43000.0,1,1,134000,173000,-39000
30,4,5,157000.0,1,1,362000,339000,23000
50,6,1,7800.0,1,1,362000,304000,58000
50,3,3,110000.0,1,1,160000,363000,-203000
35,5,1,500.0,1,1,172000,156000,16000
40,5,3,389000.0,1,1,1105000,485000,620000
60,3,1,7000.0,1,0,74000,94000,-20000
36,9,2,5000.0,1,1,281000,211000,70000
35,3,3,9000.0,1,1,280000,242000,38000
32,5,3,220000.0,0,1,1105000,521000,584000
40,3,0,0.0,0,0,75000,78000,-3000
38,1,4,0.0,0,1,121000,73000,48000
28,2,3,40000.0,1,1,356000,312000,44000
34,1,4,0.0,1,0,119000,99000,20000
35,3,2,13000.0,1,1,251000,182000,69000
37,9,1,6650.0,0,0,362000,309000,53000
21,4,3,155000.0,1,0,148000,365000,-217000
29,6,5,160000.0,0,1,286000,314000,-28000
20,3,0,0.0,2,0,65000,63000,2000
60,3,1,0.0,1,1,121000,115000,6000
31,3,3,130000.0,1,1,502000,394000,108000
50,5,4,0.0,1,1,201000,123000,78000
21,4,0,3200.0,1,1,226000,254000,-28000
46,3,3,2000.0,2,1,38000,56000,-18000
20,4,4,300000.0,2,0,520000,411000,109000
28,1,2,10000.0,1,0,402000,354000,48000
26,3,4,203500.0,1,0,702000,441000,261000
48,3,3,3000.0,2,1,63000,89000,-26000
32,3,3,10000.0,0,1,294000,260000,34000
30,3,3,32000.0,1,1,268000,324000,-56000
27,5,1,7000.0,1,0,66000,82000,-16000
32,8,5,69000.0,1,1,577000,417000,160000
38,2,3,17000.0,1,1,100000,101000,-1000
45,11,3,795000.0,0,1,1546000,1059000,487000
48,3,2,4000.0,0,1,75000,72000,3000
55,4,4,310000.0,1,0,823000,501000,322000
29,9,3,102500.0,0,1,391000,298000,93000
35,5,3,175000.0,1,1,663000,372000,291000
20,4,4,123000.0,1,1,563000,396000,167000
46,3,3,290000.0,1,1,702000,382000,320000
35,2,4,136000.0,1,1,521000,363000,158000
38,4,1,69000.0,0,1,253000,197000,56000
39,3,0,22500.0,0,1,62000,58000,4000
45,5,5,197500.0,1,1,241000,248000,-7000
39,2,4,31000.0,1,0,134000,89000,45000
35,5,4,336000.0,1,1,1085000,670000,415000
26,4,3,4000.0,1,1,113000,101000,12000
30,3,4,0.0,1,0,60000,38000,22000
36,3,4,152500.0,1,1,502000,357000,145000
31,3,3,8000.0,1,1,241000,267000,-26000
26,5,0,7000.0,0,1,163000,160000,3000
31,3,0,5000.0,1,1,151000,142000,9000
48,4,4,4500.0,2,1,126000,78000,48000
46,6,2,40000.0,1,0,134000,119000,15000
21,3,3,9000.0,2,1,97000,87000,10000
18,2,0,34000.0,2,0,48000,56000,-8000
65,4,3,64000.0,1,1,502000,848000,-346000
28,4,4,75500.0,1,1,550000,389000,161000
40,5,3,60000.0,1,1,287000,260000,27000
28,9,5,65000.0,0,0,301000,248000,53000
55,4,3,55000.0,1,1,268000,355000,-87000
24,4,3,50000.0,1,0,520000,482000,38000
28,5,1,16000.0,1,0,153000,182000,-29000
34,2,4,140000.0,1,1,602000,356000,246000
20,4,3,8000.0,1,1,268000,330000,-62000
28,3,3,56000.0,1,1,356000,260000,96000
70,4,4,182000.0,1,0,722000,516000,206000
31,3,3,180000.0,1,1,702000,366000,336000
26,3,4,67000.0,1,0,362000,234000,128000
28,5,4,69000.0,2,1,421000,266000,155000
55,9,4,2000.0,1,1,104000,89000,15000
37,3,4,143000.0,1,1,371000,284000,87000
42,3,4,0.0,1,1,301000,178000,123000
27,1,4,0.0,1,1,160000,107000,53000
70,8,4,74000.0,2,0,402000,299000,103000
37,3,5,186000.0,1,1,349000,326000,23000
28,3,3,6000.0,2,1,216000,157000,59000
31,5,4,0.0,1,0,241000,154000,87000
27,4,3,480000.0,1,1,1005000,507000,498000
28,5,0,0.0,1,1,226000,196000,30000
50,4,3,406500.0,1,1,684000,232000,452000
55,4,4,0.0,0,0,180000,125000,55000
50,4,3,102000.0,1,1,434000,187000,247000
20,5,3,77000.0,1,0,502000,324000,178000
39,4,4,0.0,1,0,100000,138000,-38000
36,4,0,0.0,1,1,251000,221000,30000
35,2,3,63000.0,1,1,402000,159000,243000
62,5,5,9000.0,1,0,446000,291000,155000
58,8,4,14008.0,0,1,271000,174000,97000
55,5,4,210000.0,1,1,317000,320000,-3000
22,5,3,185000.0,1,0,753000,473000,280000
26,2,1,0.0,1,0,100000,85000,15000
28,4,3,180000.0,1,0,702000,436000,266000
35,4,5,424000.0,1,1,1105000,893000,212000
32,3,4,30000.0,2,1,201000,136000,65000
50,4,0,0.0,1,1,125000,115000,10000
40,4,5,9000.0,1,1,446000,280000,166000
32,5,4,0.0,2,1,301000,190000,111000
23,5,0,24500.0,0,1,86000,93000,-7000
35,5,3,13000.0,1,1,374000,397000,-23000
42,2,4,100000.0,1,1,421000,304000,117000
40,3,0,5000.0,1,0,51000,46000,5000
33,5,0,3000.0,1,1,332000,347000,-15000
50,4,3,260000.0,1,1,903000,441000,462000
32,10,1,1000.0,1,1,52000,58000,-6000
60,5,4,16500.0,1,1,229000,223000,6000
36,4,4,0.0,0,1,180000,120000,60000
30,4,4,140000.0,1,0,602000,338000,264000
35,4,1,0.0,1,0,72000,75000,-3000
34,3,0,2600.0,1,1,201000,184000,17000
31,4,4,155000.0,1,0,502000,345000,157000
21,4,3,7000.0,2,0,238000,186000,52000
40,4,4,30000.0,1,1,223000,321000,-98000
18,4,5,9000.0,1,0,446000,303000,143000
20,3,3,176000.0,1,1,663000,365000,298000
28,5,0,5000.0,1,1,124000,127000,-3000
32,4,0,0.0,0,0,160000,134000,26000
37,3,5,289000.0,1,0,823000,621000,202000
48,3,4,0.0,0,0,241000,145000,96000
62,4,4,135000.0,1,0,521000,342000,179000
32,3,4,35000.0,1,0,301000,191000,110000
35,5,4,81650.0,1,1,502000,321000,181000
36,4,3,1150000.0,1,1,2008000,915000,1093000
20,1,3,178500.0,1,0,502000,388000,114000
40,8,1,6650.0,1,1,362000,267000,95000
70,3,4,0.0,1,1,119000,93000,26000
38,5,0,5000.0,1,1,88000,82000,6000
35,3,5,2510.0,1,1,126000,229000,-103000
20,2,1,0.0,1,1,100000,106000,-6000
32,4,3,8000.0,1,1,301000,238000,63000
30,5,3,1010000.0,1,1,1406000,761000,645000
33,3,3,472000.0,1,1,1041000,630000,411000
40,4,4,3000.0,1,1,213000,157000,56000
19,3,1,8650.0,0,1,54000,63000,-9000
30,8,4,133000.0,1,1,512000,287000,225000
65,3,1,4700.0,0,1,80000,77000,3000
24,6,0,1000.0,1,1,256000,224000,32000
31,4,5,0.0,1,1,180000,160000,20000
60,1,4,0.0,1,0,160000,104000,56000
57,5,0,4500.0,1,1,60000,66000,-6000
45,5,4,138200.0,1,1,563000,302000,261000
24,3,3,5000.0,1,1,90000,117000,-27000
34,3,1,7000.0,1,1,72000,78000,-6000
30,4,3,62000.0,1,1,402000,342000,60000
36,4,3,8000.0,2,1,275000,215000,60000
29,4,3,6000.0,1,0,180000,194000,-14000
45,2,3,39000.0,2,1,160000,94000,66000
34,4,0,13500.0,1,0,113000,105000,8000
50,5,3,270000.0,1,1,723000,470000,253000
26,2,1,7000.0,1,0,100000,88000,12000
25,2,4,7000.0,0,1,269000,170000,99000
36,5,3,187002.0,1,1,282000,363000,-81000
42,2,4,0.0,1,1,119000,100000,19000
36,4,3,3000.0,1,1,80000,163000,-83000
38,9,3,157000.0,1,1,502000,306000,196000
36,4,4,172000.0,1,1,621000,354000,267000
38,4,4,0.0,2,1,140000,98000,42000
30,2,4,209004.0,0,0,261000,156000,105000
55,5,4,0.0,0,0,100000,85000,15000
50,4,4,15000.0,1,1,68000,63000,5000
38,2,4,138000.0,1,1,561000,350000,211000
24,4,3,960000.0,1,0,1606000,1016000,590000
23,6,4,0.0,0,0,221000,130000,91000
50,4,1,13500.0,2,1,99000,107000,-8000
60,4,3,210000.0,2,1,206000,173000,33000
65,9,3,224000.0,1,1,904000,450000,454000
36,2,4,0.0,0,1,160000,104000,56000
40,1,4,0.0,2,1,35000,23000,12000
21,3,2,188000.0,1,0,223000,324000,-101000
20,4,3,415500.0,1,1,702000,438000,264000
50,3,2,2000.0,0,1,36000,36000,0
40,4,4,68000.0,1,1,381000,281000,100000
29,3,3,30000.0,1,1,301000,301000,0
25,3,3,50000.0,1,1,251000,227000,24000
65,5,3,47000.0,0,1,321000,256000,65000
55,3,0,1000.0,1,1,65000,63000,2000
35,5,1,0.0,1,1,131000,116000,15000
70,2,1,7000.0,1,1,100000,119000,-19000
65,3,3,150000.0,1,1,844000,450000,394000
60,1,4,136000.0,1,1,520000,285000,235000
20,2,5,136600.0,2,0,178000,188000,-10000
20,8,4,0.0,0,1,75000,45000,30000
26,4,1,1000.0,1,1,97000,86000,11000
55,3,3,252000.0,1,0,723000,309000,414000
27,4,4,182000.0,1,0,722000,493000,229000
28,4,3,605000.0,1,1,1406000,339000,1067000
60,6,5,170000.0,1,1,743000,474000,269000
22,2,4,0.0,0,1,221000,130000,91000
35,12,3,14000.0,2,1,180000,206000,-26000
58,5,1,11700.0,0,1,183000,174000,9000
55,5,4,85000.0,1,1,356000,253000,103000
32,5,1,50000.0,1,1,251000,214000,37000
40,3,4,0.0,0,1,281000,206000,75000
35,5,4,400000.0,1,1,1005000,599000,406000
20,4,3,130000.0,1,0,602000,896000,-294000
45,5,1,20000.0,1,1,100000,103000,-3000
29,5,2,6000.0,1,0,75000,77000,-2000
50,4,1,0.0,1,0,178000,211000,-33000
26,4,3,310000.0,1,1,702000,469000,233000
28,3,4,0.0,2,1,140000,123000,17000
59,3,1,0.0,0,1,253000,245000,8000
34,4,4,31000.0,1,1,187000,137000,50000
27,2,4,33500.0,0,1,60000,43000,17000
57,3,4,0.0,0,1,113000,74000,39000
25,3,4,0.0,0,1,88000,139000,-51000
30,8,4,44500.0,0,1,332000,215000,117000
50,4,3,102000.0,1,1,363000,387000,-24000
30,4,0,3500.0,1,1,201000,175000,26000
35,4,3,156240.0,0,1,1082000,500000,582000
30,3,5,18000.0,2,1,194000,176000,18000
34,5,4,130000.0,0,1,281000,222000,59000
26,4,5,31500.0,0,0,502000,338000,164000
22,2,3,380000.0,1,0,803000,525000,278000
33,4,4,760000.0,1,0,1406000,696000,710000
29,4,3,550000.0,1,1,702000,493000,209000
30,9,5,175000.0,0,0,804000,540000,264000
36,1,2,5000.0,2,0,33000,53000,-20000
32,5,5,15000.0,1,1,602000,450000,152000
28,4,4,140500.0,1,0,520000,347000,173000
28,5,4,269000.0,1,0,502000,298000,204000
26,4,1,0.0,1,0,143000,148000,-5000
50,5,4,0.0,2,1,75000,62000,13000
35,2,3,48000.0,2,1,147000,146000,1000
31,3,4,117000.0,1,0,362000,231000,131000
30,5,3,311700.0,1,0,702000,495000,207000
50,3,2,8000.0,0,1,36000,35000,1000
38,3,4,0.0,2,1,51000,37000,14000
75,4,3,7000.0,1,1,241000,171000,70000
39,5,5,268500.0,1,1,713000,543000,170000
47,6,4,483500.0,1,1,817000,489000,328000
44,4,4,75000.0,0,0,249000,147000,102000
38,4,1,500.0,1,1,144000,117000,27000
35,3,5,15000.0,2,0,743000,557000,186000
28,4,5,6000.0,2,1,178000,171000,7000
95,2,3,49000.0,2,1,386000,250000,136000
35,4,5,517000.0,1,1,1305000,743000,562000
26,9,4,240000.0,2,0,420000,536000,-116000
50,5,3,64000.0,1,1,372000,492000,-120000
21,4,4,0.0,2,0,241000,195000,46000
22,4,4,0.0,1,1,241000,181000,60000
18,2,3,61000.0,0,0,362000,264000,98000
45,4,3,58500.0,1,1,446000,664000,-218000
28,5,4,12000.0,1,1,196000,140000,56000
30,2,3,130000.0,1,1,502000,389000,113000
55,3,0,7000.0,0,1,91000,92000,-1000
35,5,5,8000.0,1,1,442000,359000,83000
40,8,3,75000.0,1,1,490000,348000,142000
56,3,4,180000.0,1,1,702000,402000,300000
48,3,2,3000.0,0,1,63000,54000,9000
24,2,5,51000.0,1,1,83000,82000,1000
25,6,1,0.0,0,1,180000,203000,-23000
20,4,3,50000.0,0,0,263000,221000,42000
55,4,4,0.0,1,1,80000,133000,-53000
32,8,1,19000.0,2,1,135000,125000,10000
70,6,4,70000.0,1,0,414000,269000,145000
50,5,3,159000.0,0,1,502000,637000,-135000
27,3,0,0.0,2,1,55000,52000,3000
21,3,0,0.0,2,1,65000,55000,10000
32,3,4,1360000.0,1,1,1908000,622000,1286000
53,3,3,960000.0,1,1,1606000,881000,725000
32,5,5,154000.0,0,0,1005000,681000,324000
55,3,2,5000.0,1,1,112000,140000,-28000
30,4,3,100000.0,1,0,602000,452000,150000
25,1,4,0.0,1,1,160000,153000,7000
22,6,1,29200.0,0,1,301000,248000,53000
18,9,3,47000.0,1,0,234000,270000,-36000
34,5,5,21000.0,1,0,446000,376000,70000
28,5,4,344000.0,1,1,693000,420000,273000
50,4,4,94000.0,0,1,359000,209000,150000
35,4,0,0.0,2,1,48000,43000,5000
30,4,4,20500.0,0,0,122000,92000,30000
28,4,4,15000.0,0,0,174000,173000,1000
26,5,3,380000.0,1,1,904000,511000,393000
25,5,4,17000.0,0,0,241000,160000,81000
28,4,3,418500.0,1,1,1115000,410000,705000
33,4,4,262500.0,1,1,520000,432000,88000
27,2,4,95000.0,1,1,416000,241000,175000
34,4,4,132000.0,2,1,290000,218000,72000
54,4,0,0.0,1,0,113000,99000,14000
44,3,0,0.0,1,0,201000,192000,9000
19,5,4,0.0,1,0,191000,132000,59000
50,4,5,8000.0,0,1,281000,261000,20000
27,10,1,3100.0,1,1,222000,162000,60000
50,3,3,21000.0,1,1,121000,111000,10000
42,2,5,190000.0,1,1,238000,209000,29000
18,5,3,24150.0,1,1,301000,283000,18000
30,5,4,50000.0,1,0,253000,184000,69000
59,9,3,3800.0,1,1,99000,177000,-78000
50,2,4,0.0,1,0,140000,94000,46000
48,1,4,0.0,1,1,62000,80000,-18000
40,4,3,847500.0,1,1,1606000,908000,698000
28,4,0,0.0,1,0,100000,107000,-7000
51,5,4,118251.0,1,1,374000,220000,154000
50,4,5,185000.0,1,1,520000,335000,185000
40,3,5,222500.0,1,1,520000,318000,202000
35,5,4,91100.0,1,1,376000,221000,155000
55,4,4,10000.0,1,1,100000,86000,14000
50,2,1,13000.0,0,1,48000,42000,6000
31,4,0,0.0,1,1,80000,103000,-23000
28,2,4,180000.0,1,0,702000,446000,256000
62,6,1,23200.0,0,1,90000,101000,-11000
28,4,3,494000.0,1,1,877000,562000,315000
35,3,4,0.0,0,0,180000,113000,67000
42,2,4,32000.0,0,1,192000,111000,81000
27,10,4,0.0,0,1,261000,162000,99000
45,4,4,0.0,1,1,160000,121000,39000
35,2,4,25000.0,1,1,180000,133000,47000
70,4,3,262000.0,0,1,624000,381000,243000
27,5,4,902000.0,1,0,1412000,658000,754000
26,3,4,115000.0,1,1,371000,342000,29000
19,8,3,7000.0,1,1,502000,355000,147000
32,4,3,75000.0,1,1,492000,386000,106000
50,3,3,95000.0,1,1,110000,144000,-34000
55,1,5,5000.0,0,0,30000,34000,-4000
55,4,3,57000.0,1,1,482000,321000,161000
31,5,4,232000.0,1,0,535000,315000,220000
28,4,4,307500.0,1,1,743000,477000,266000
30,5,3,240000.0,1,1,844000,520000,324000
45,3,3,8000.0,1,1,214000,173000,41000
36,4,4,104200.0,1,0,104000,69000,35000
23,5,4,185000.0,0,1,637000,423000,214000
35,2,4,180000.0,1,0,702000,392000,310000
32,3,3,109000.0,1,1,362000,283000,79000
27,4,5,9000.0,1,0,446000,311000,135000
45,5,3,67000.0,0,1,402000,167000,235000
40,2,3,6000.0,1,1,90000,115000,-25000
29,9,4,83000.0,1,0,371000,215000,156000
48,5,3,23000.0,2,1,100000,152000,-52000
20,2,5,169000.0,1,1,268000,250000,18000
27,8,4,349000.0,2,0,525000,323000,202000
58,5,4,137000.0,1,1,563000,398000,165000
36,1,4,0.0,1,1,119000,94000,25000
36,5,4,70000.0,1,0,442000,296000,146000
42,3,2,89000.0,1,1,125000,166000,-41000
32,4,1,3000.0,1,1,74000,64000,10000
80,4,4,32000.0,1,1,119000,117000,2000
31,3,0,40000.0,1,1,100000,88000,12000
45,3,5,21000.0,2,1,60000,91000,-31000
80,5,1,0.0,1,1,72000,61000,11000
60,3,4,48000.0,1,1,440000,292000,148000
20,6,4,200000.0,0,1,303000,207000,96000
46,2,0,15000.0,1,1,80000,97000,-17000
30,5,1,15000.0,1,0,148000,128000,20000
40,3,5,260000.0,1,1,763000,578000,185000
30,3,4,0.0,2,0,221000,212000,9000
23,4,4,43700.0,2,1,376000,269000,107000
23,8,3,24000.0,1,1,281000,223000,58000
27,4,3,41500.0,1,1,372000,321000,51000
22,3,0,0.0,2,1,80000,69000,11000
25,5,4,135000.0,1,1,520000,415000,105000
28,5,1,6560.0,1,1,68000,59000,9000
38,4,3,85000.0,1,1,482000,431000,51000
36,3,4,15000.0,1,0,100000,85000,15000
55,2,5,155000.0,1,1,683000,458000,225000
47,4,3,7000.0,1,1,214000,200000,14000
34,6,4,53500.0,1,0,414000,247000,167000
26,4,1,0.0,1,1,143000,145000,-2000
26,5,0,5000.0,1,0,351000,358000,-7000
50,5,4,44000.0,0,0,90000,69000,21000
27,5,1,7000.0,1,1,301000,215000,86000
55,4,4,0.0,0,0,301000,196000,105000
32,2,4,37000.0,1,1,253000,155000,98000
26,4,3,302000.0,1,0,1029000,600000,429000
60,3,0,6000.0,2,1,60000,64000,-4000
56,4,0,20000.0,1,1,176000,157000,19000
30,5,5,180000.0,0,1,301000,296000,5000
35,11,5,59000.0,2,1,556000,394000,162000
58,4,5,77000.0,1,1,194000,198000,-4000
56,2,4,51060.0,1,1,265000,154000,111000
28,2,4,16000.0,1,1,148000,103000,45000
29,2,0,0.0,1,1,133000,126000,7000
25,1,5,10000.0,1,1,153000,146000,7000
21,5,1,3600.0,1,1,52000,51000,1000
28,4,4,175000.0,1,1,702000,447000,255000
27,5,0,20000.0,1,1,100000,88000,12000
28,4,5,55000.0,1,1,803000,724000,79000
65,5,1,36000.0,0,1,211000,161000,50000
29,4,0,2000.0,0,1,140000,148000,-8000
32,3,0,0.0,1,1,201000,207000,-6000
60,3,5,10000.0,1,1,502000,375000,127000
36,3,2,8000.0,1,1,251000,215000,36000
40,3,0,0.0,0,1,73000,65000,8000
40,3,4,1200000.0,1,1,2008000,628000,1380000
60,4,4,0.0,1,1,119000,134000,-15000
60,3,3,85000.0,1,1,362000,274000,88000
53,5,4,285000.0,1,1,528000,358000,170000
31,1,2,10000.0,1,1,201000,193000,8000
21,4,4,170000.0,1,1,602000,311000,291000
70,2,3,202800.0,1,0,446000,603000,-157000
30,6,4,67000.0,1,0,381000,256000,125000
21,4,3,417300.0,1,0,1041000,722000,319000
44,1,4,0.0,1,1,131000,91000,40000
50,4,1,58000.0,1,1,251000,227000,24000
26,5,1,5000.0,1,1,116000,148000,-32000
46,2,2,8000.0,1,0,129000,143000,-14000
63,2,5,10000.0,1,1,356000,321000,35000
57,9,4,17820.0,1,1,37000,26000,11000
50,2,2,7000.0,2,1,98000,128000,-30000
34,5,4,0.0,0,0,51000,38000,13000
18,3,4,295000.0,0,1,563000,349000,214000
26,2,3,57000.0,1,1,356000,256000,100000
36,2,4,1276000.0,1,1,3213000,1372000,1841000
21,5,4,400000.0,2,1,620000,358000,262000
53,6,1,12000.0,1,1,74000,61000,13000
52,3,3,115000.0,2,1,298000,229000,69000
60,4,3,220000.0,1,1,702000,469000,233000
30,2,2,30000.0,1,1,297000,232000,65000
75,5,3,131000.0,1,1,491000,613000,-122000
18,5,5,51000.0,1,1,388000,384000,4000
39,3,4,720000.0,1,1,1807000,621000,1186000
40,4,2,111000.0,2,0,342000,281000,61000
23,2,3,311700.0,1,1,702000,313000,389000
59,2,3,9000.0,1,1,193000,188000,5000
40,5,3,56000.0,1,1,362000,163000,199000
28,2,3,155000.0,1,0,502000,342000,160000
47,5,1,10000.0,0,1,180000,182000,-2000
21,3,5,10000.0,1,1,602000,392000,210000
45,4,0,4500.0,1,0,30000,33000,-3000
43,4,3,200000.0,1,1,904000,534000,370000
35,9,4,64000.0,1,1,362000,273000,89000
37,4,4,139000.0,1,0,580000,343000,237000
80,5,5,61000.0,1,0,335000,281000,54000
42,10,3,17000.0,1,1,205000,173000,32000
30,5,4,0.0,1,0,113000,107000,6000
20,8,5,175000.0,0,0,317000,292000,25000
60,4,1,23500.0,0,1,171000,187000,-16000
43,3,4,30500.0,2,1,134000,109000,25000
28,5,4,0.0,0,1,113000,87000,26000
53,5,0,10000.0,1,1,38000,41000,-3000
32,2,5,108000.0,1,1,163000,152000,11000
27,5,3,264000.0,1,1,622000,472000,150000
85,5,4,127000.0,0,1,394000,286000,108000
73,5,4,35000.0,0,1,241000,164000,77000
58,4,4,369117.0,1,0,803000,434000,369000
35,4,3,305000.0,1,1,771000,483000,288000
32,4,1,6500.0,0,1,244000,225000,19000
34,2,3,234000.0,1,0,669000,324000,345000
56,8,5,11000.0,1,1,88000,79000,9000
60,6,5,225000.0,1,1,683000,496000,187000
30,5,3,306000.0,1,0,627000,385000,242000
27,12,1,8000.0,1,0,376000,466000,-90000
48,5,4,27000.0,0,1,221000,153000,68000
45,3,3,130000.0,1,0,371000,308000,63000
19,3,3,785000.0,1,0,1305000,741000,564000
56,5,3,70000.0,2,0,462000,438000,24000
31,4,3,58000.0,1,1,301000,272000,29000
36,5,0,0.0,1,1,63000,59000,4000
30,2,1,9000.0,0,0,48000,44000,4000
20,4,2,9000.0,1,0,502000,329000,173000
18,9,1,6500.0,0,1,191000,199000,-8000
58,2,1,45000.0,1,1,72000,70000,2000
23,4,2,95000.0,0,0,604000,438000,166000
43,11,3,40000.0,1,1,352000,293000,59000
20,5,5,5000.0,1,1,177000,163000,14000
34,4,5,21000.0,1,0,225000,170000,55000
28,4,4,90000.0,0,1,216000,210000,6000
28,3,3,45000.0,1,1,362000,345000,17000
24,6,5,16450.0,1,0,84000,150000,-66000
23,4,3,135000.0,1,1,602000,364000,238000
45,4,4,0.0,1,1,96000,144000,-48000
42,3,2,3000.0,0,1,58000,59000,-1000
34,5,2,57000.0,1,1,251000,233000,18000
48,4,5,270000.0,1,1,669000,452000,217000
28,3,0,0.0,1,1,125000,120000,5000
31,4,4,182000.0,1,0,722000,492000,230000
35,5,1,15400.0,0,1,84000,101000,-17000
31,5,5,20200.0,1,0,308000,311000,-3000
30,5,4,37508.0,0,1,317000,207000,110000
60,2,3,63000.0,1,1,402000,151000,251000
26,2,3,130000.0,1,0,502000,423000,79000
20,3,4,5400.0,2,0,244000,145000,99000
30,1,2,10000.0,1,0,180000,174000,6000
20,5,4,0.0,0,1,241000,153000,88000
38,3,0,0.0,1,1,100000,112000,-12000
38,3,2,4000.0,0,1,40000,51000,-11000
60,3,3,2000.0,2,1,45000,75000,-30000
30,6,4,22000.0,0,0,120000,122000,-2000
27,2,4,12000.0,1,0,178000,116000,62000
25,2,0,0.0,1,1,160000,144000,16000
27,3,3,2000.0,0,0,38000,40000,-2000
28,5,4,316000.0,1,1,362000,443000,-81000
37,8,5,41800.0,1,1,188000,156000,32000
40,4,5,80000.0,1,1,520000,447000,73000
40,3,4,186500.0,1,1,602000,346000,256000
65,4,1,3200.0,1,1,46000,61000,-15000
31,5,4,30000.0,2,1,203000,184000,19000
29,5,5,2000.0,1,1,100000,139000,-39000
20,4,4,0.0,1,1,119000,111000,8000
35,2,4,55000.0,1,1,374000,224000,150000
29,4,1,65000.0,1,0,144000,167000,-23000
34,1,5,9000.0,1,1,97000,138000,-41000
35,9,4,70000.0,0,1,410000,242000,168000
33,4,1,0.0,1,1,261000,203000,58000
27,4,5,10000.0,1,0,643000,458000,185000
25,3,1,10000.0,1,1,89000,86000,3000
35,1,4,40000.0,0,1,261000,153000,108000
35,5,4,0.0,1,1,80000,140000,-60000
26,4,1,3000.0,1,1,74000,61000,13000
28,4,4,105000.0,1,1,520000,308000,212000
30,5,1,3450.0,1,1,37000,34000,3000
50,8,0,0.0,1,0,246000,208000,38000
41,3,1,5800.0,1,1,100000,135000,-35000
35,3,4,42000.0,0,1,180000,104000,76000
40,8,3,14000.0,1,1,160000,192000,-32000
42,3,4,0.0,0,0,25000,22000,3000
32,2,5,10000.0,1,1,301000,253000,48000
25,3,1,11000.0,1,1,66000,65000,1000
45,2,4,4500.0,2,0,112000,76000,36000
38,3,4,200000.0,1,1,904000,507000,397000
36,3,4,0.0,2,1,159000,232000,-73000
36,4,5,160000.0,1,1,702000,379000,323000
52,3,2,28000.0,0,0,251000,209000,42000
20,4,4,760000.0,1,1,1406000,663000,743000
20,8,1,21500.0,0,1,189000,179000,10000
63,4,3,35100.0,1,1,321000,241000,80000
21,3,4,0.0,2,1,4000,2000,2000
24,4,4,958000.0,1,1,1707000,526000,1181000
38,3,3,170000.0,1,1,702000,418000,284000
28,4,5,835000.0,2,1,1263000,821000,442000
20,4,3,20000.0,1,1,193000,336000,-143000
50,8,5,5000.0,1,1,259000,314000,-55000
28,3,5,8000.0,1,0,214000,157000,57000
37,2,5,76500.0,1,1,160000,161000,-1000
22,16,2,58000.0,1,1,757000,622000,135000
48,4,0,1000.0,1,1,100000,98000,2000
31,2,2,75000.0,1,1,1770000,1117000,653000
48,2,4,85000.0,1,1,502000,374000,128000
30,3,4,900000.0,1,1,1606000,836000,770000
34,4,4,0.0,2,0,98000,76000,22000
19,4,4,316500.0,1,1,550000,399000,151000
20,4,4,498000.0,1,1,1005000,550000,455000
62,8,5,43500.0,0,1,362000,288000,74000
65,4,3,286000.0,1,1,803000,591000,212000
55,1,1,36000.0,0,1,32000,37000,-5000
23,4,3,180000.0,1,1,602000,494000,108000
40,3,2,13500.0,0,1,25000,24000,1000
27,8,3,222000.0,1,1,1130000,578000,552000
40,9,4,1160000.0,1,1,3012000,559000,2453000
61,3,3,180000.0,1,1,602000,506000,96000
23,5,4,0.0,1,1,121000,101000,20000
37,5,4,26000.0,0,1,133000,123000,10000
46,3,2,20000.0,2,1,60000,71000,-11000
23,3,2,106000.0,1,1,125000,166000,-41000
45,4,5,27500.0,1,1,678000,405000,273000
24,4,0,0.0,2,1,302000,323000,-21000
30,3,1,0.0,1,1,124000,135000,-11000
20,1,2,8000.0,2,1,80000,86000,-6000
23,4,4,176000.0,1,1,661000,460000,201000
24,4,4,115000.0,2,1,495000,325000,170000
48,6,3,185000.0,1,1,594000,447000,147000
26,3,3,71000.0,1,1,586000,456000,130000
24,4,4,0.0,1,1,201000,124000,77000
52,3,1,54000.0,1,1,83000,69000,14000
32,4,1,5000.0,1,1,100000,103000,-3000
68,1,4,6700.0,0,1,180000,121000,59000
62,2,4,0.0,2,1,282000,197000,85000
58,2,5,10000.0,1,0,297000,293000,4000
48,9,4,68000.0,1,1,366000,262000,104000
20,4,3,325000.0,1,1,702000,170000,532000
72,4,4,305000.0,1,1,669000,440000,229000
27,3,5,100000.0,1,1,371000,357000,14000
66,4,3,148500.0,1,1,371000,470000,-99000
40,3,1,0.0,1,1,121000,131000,-10000
65,5,5,35000.0,1,0,402000,355000,47000
55,6,4,240000.0,1,1,535000,359000,176000
38,2,4,5000.0,0,1,183000,127000,56000
42,4,5,35000.0,2,1,1189000,656000,533000
72,5,3,55000.0,1,1,276000,238000,38000
21,5,5,928000.0,1,1,2008000,1020000,988000
42,4,4,710000.0,1,1,1105000,621000,484000
32,9,5,265000.0,1,1,863000,595000,268000
74,3,3,311100.0,1,1,669000,273000,396000
50,5,1,37000.0,0,1,261000,250000,11000
21,4,3,47000.0,1,1,502000,329000,173000
50,4,2,3000.0,2,1,70000,86000,-16000
40,4,4,0.0,1,1,90000,71000,19000
35,3,2,2000.0,0,1,38000,29000,9000
45,4,1,4000.0,1,1,100000,99000,1000
21,5,1,78000.0,0,1,261000,228000,33000
19,3,5,155000.0,1,0,702000,512000,190000
38,4,3,8000.0,1,1,268000,320000,-52000
36,9,3,185200.0,1,1,703000,224000,479000
29,5,4,0.0,2,1,121000,79000,42000
40,4,4,186500.0,1,1,702000,431000,271000
47,5,3,290000.0,1,1,763000,372000,391000
35,3,4,102000.0,0,0,552000,380000,172000
60,3,4,21300.0,2,0,200000,147000,53000
38,3,2,4000.0,0,1,80000,73000,7000
20,2,4,7500.0,0,0,249000,165000,84000
36,3,0,0.0,1,0,113000,105000,8000
40,5,3,80000.0,1,0,301000,315000,-14000
26,9,4,65800.0,1,1,401000,290000,111000
36,4,0,44008.0,1,0,84000,77000,7000
45,3,3,0.0,1,1,251000,223000,28000
23,4,3,8000.0,1,1,268000,316000,-48000
40,5,3,1260000.0,1,1,2008000,1169000,839000
19,2,0,0.0,1,1,160000,150000,10000
34,10,1,121500.0,1,1,217000,175000,42000
29,3,4,50000.0,2,1,60000,37000,23000
32,3,3,110000.0,1,1,502000,276000,226000
34,4,3,85000.0,1,1,563000,374000,189000
27,5,5,21500.0,1,1,244000,253000,-9000
82,4,3,36000.0,2,1,180000,194000,-14000
50,8,1,8500.0,1,1,112000,94000,18000
32,10,3,12500.0,0,1,154000,254000,-100000
30,4,0,0.0,0,1,180000,172000,8000
62,2,2,9000.0,1,1,241000,181000,60000
23,9,2,6500.0,1,1,115000,168000,-53000
32,3,3,41000.0,1,1,251000,177000,74000
50,3,3,39000.0,1,1,362000,324000,38000
34,2,2,12000.0,2,1,143000,160000,-17000
18,3,5,42000.0,2,1,163000,170000,-7000
33,4,1,20500.0,0,1,154000,145000,9000
45,5,1,6650.0,0,0,191000,157000,34000
58,9,4,9000.0,0,0,201000,191000,10000
30,3,5,10000.0,1,1,803000,613000,190000
40,4,5,150000.0,1,1,178000,217000,-39000
56,5,4,1074000.0,1,0,1486000,592000,894000
27,4,1,8000.0,1,1,70000,77000,-7000
22,8,3,225000.0,0,0,646000,353000,293000
37,3,1,18000.0,2,1,70000,79000,-9000
32,10,4,300000.0,2,1,517000,324000,193000
40,10,3,23000.0,1,1,221000,165000,56000
45,6,4,377500.0,1,1,817000,453000,364000
50,2,3,45000.0,1,1,225000,171000,54000
34,3,4,20000.0,0,1,191000,121000,70000
63,6,4,389000.0,1,1,743000,449000,294000
35,4,4,360000.0,1,1,967000,618000,349000
36,2,4,0.0,1,1,80000,51000,29000
58,3,5,10000.0,1,1,578000,332000,246000
51,6,4,225000.0,0,0,417000,262000,155000
42,5,3,46000.0,2,0,202000,183000,19000
23,6,1,13000.0,0,1,264000,289000,-25000
23,4,1,3000.0,1,1,80000,84000,-4000
34,6,4,55000.0,1,1,423000,257000,166000
22,4,3,160000.0,1,1,954000,629000,325000
20,9,1,0.0,1,1,185000,186000,-1000
52,4,5,147500.0,1,1,502000,368000,134000
20,3,0,0.0,1,1,121000,100000,21000
27,4,1,5000.0,1,1,160000,142000,18000
26,5,4,0.0,1,1,281000,220000,61000
49,4,4,250000.0,1,1,702000,450000,252000
20,9,3,210000.0,1,0,903000,520000,383000
46,4,4,0.0,2,1,166000,100000,66000
27,3,2,2000.0,0,1,38000,36000,2000
27,4,5,52000.0,1,1,171000,164000,7000
22,4,3,50000.0,1,1,520000,605000,-85000
26,5,0,0.0,0,0,88000,100000,-12000
63,2,1,5000.0,1,1,74000,82000,-8000
23,5,4,0.0,2,1,251000,258000,-7000
33,4,4,150000.0,1,0,301000,195000,106000
52,4,4,690000.0,1,1,1105000,519000,586000
18,4,3,74000.0,0,1,227000,244000,-17000
68,3,3,15500.0,1,1,63000,101000,-38000
25,4,4,1060000.0,1,0,2892000,1021000,1871000
35,8,4,47000.0,1,1,402000,236000,166000
34,3,0,5800.0,2,0,45000,43000,2000
18,3,2,7000.0,0,1,48000,71000,-23000
22,5,0,14200.0,1,1,37000,34000,3000
45,4,3,195000.0,1,1,702000,483000,219000
22,5,4,110000.0,0,1,542000,331000,211000
20,2,5,253000.0,1,1,285000,277000,8000
52,5,5,170000.0,1,1,844000,803000,41000
27,4,3,2100000.0,1,1,2008000,1248000,760000
32,4,4,262500.0,1,1,520000,439000,81000
85,2,4,0.0,1,1,160000,110000,50000
36,3,0,0.0,0,1,53000,53000,0
60,5,1,1000.0,1,1,301000,267000,34000
33,4,4,200000.0,1,1,362000,311000,51000
35,8,2,1000.0,1,1,75000,64000,11000
73,4,1,0.0,1,1,100000,92000,8000
52,5,5,210000.0,1,1,763000,530000,233000
19,3,5,239000.0,1,1,904000,691000,213000
48,5,4,150000.0,1,0,313000,433000,-120000
28,4,4,155000.0,1,0,297000,183000,114000
18,5,3,16500.0,2,1,80000,71000,9000
42,5,1,57000.0,0,1,261000,213000,48000
31,5,3,380000.0,1,1,803000,454000,349000
33,8,5,1000.0,0,1,75000,115000,-40000
30,2,0,0.0,1,1,160000,142000,18000
39,3,4,595000.0,1,1,1204000,669000,535000
71,4,1,4000.0,1,0,100000,93000,7000
52,5,3,165135.0,0,1,500000,354000,146000
33,9,4,0.0,1,1,113000,107000,6000
30,6,5,30000.0,1,0,355000,303000,52000
27,4,4,140000.0,0,0,219000,274000,-55000
25,4,5,6000.0,1,1,189000,241000,-52000
31,3,4,145000.0,1,1,416000,317000,99000
28,10,1,42700.0,1,1,281000,240000,41000
20,5,3,255000.0,1,1,1029000,514000,515000
36,4,4,0.0,1,1,80000,127000,-47000
36,4,4,0.0,2,1,119000,112000,7000
31,4,3,301500.0,1,1,476000,243000,233000
30,2,2,31000.0,1,0,275000,364000,-89000
50,4,3,305000.0,1,1,868000,582000,286000
33,3,1,0.0,1,1,100000,91000,9000
45,5,2,7000.0,1,0,251000,212000,39000
28,2,5,16000.0,2,0,275000,327000,-52000
28,5,3,45000.0,1,1,193000,127000,66000
29,4,4,57000.0,1,1,376000,250000,126000
31,1,2,8000.0,0,1,75000,98000,-23000
39,5,3,1282300.0,1,0,1828000,1209000,619000
40,3,5,18000.0,1,1,381000,328000,53000
34,4,4,67000.0,1,1,362000,270000,92000
35,5,4,71500.0,1,1,261000,162000,99000
37,3,4,16000.0,1,1,187000,153000,34000
38,4,1,0.0,2,1,160000,185000,-25000
30,4,3,212500.0,1,1,520000,375000,145000
32,8,0,5000.0,1,1,351000,396000,-45000
35,8,1,0.0,1,1,304000,329000,-25000
28,4,0,10000.0,1,1,51000,51000,0
40,1,2,4000.0,2,1,25000,32000,-7000
27,4,5,26600.0,1,0,446000,320000,126000
39,5,4,0.0,2,1,75000,54000,21000
30,4,4,0.0,1,0,60000,40000,20000
48,2,2,285000.0,1,0,1426000,1000000,426000
40,4,1,3000.0,1,1,76000,63000,13000
30,5,0,0.0,1,1,104000,98000,6000
40,4,5,106000.0,1,1,339000,316000,23000
30,5,3,420000.0,1,1,964000,580000,384000
49,4,5,11000.0,1,1,241000,242000,-1000
55,4,4,271000.0,1,1,442000,270000,172000
48,4,0,0.0,1,1,201000,198000,3000
25,5,3,84050.0,0,1,143000,140000,3000
18,4,1,4000.0,1,1,89000,80000,9000
25,5,3,475000.0,1,1,743000,391000,352000
27,3,4,196000.0,1,0,862000,461000,401000
20,4,0,10000.0,1,1,113000,103000,10000
35,4,5,50000.0,1,1,371000,443000,-72000
32,6,4,172500.0,1,0,446000,442000,4000
38,4,4,155000.0,1,0,520000,359000,161000
28,3,4,0.0,0,1,201000,121000,80000
47,3,3,20000.0,1,1,301000,335000,-34000
80,3,3,84000.0,1,0,502000,378000,124000
50,4,0,6000.0,1,1,178000,157000,21000
27,6,3,13000.0,1,1,121000,135000,-14000
35,3,3,330000.0,1,1,1205000,638000,567000
46,4,3,113000.0,2,0,342000,204000,138000
22,3,4,139000.0,1,1,581000,330000,251000
65,4,4,54000.0,2,0,320000,198000,122000
55,4,5,157000.0,2,1,238000,201000,37000
46,4,3,63008.0,0,1,482000,207000,275000
32,5,4,310000.0,0,1,520000,352000,168000
35,5,4,20000.0,1,1,113000,113000,0
30,4,3,55000.0,0,1,485000,541000,-56000
36,3,4,31200.0,0,1,271000,199000,72000
30,4,1,9000.0,1,0,72000,91000,-19000
43,9,4,529000.0,2,1,455000,269000,186000
55,12,5,125000.0,0,1,393000,330000,63000
32,4,1,18000.0,1,1,89000,79000,10000
25,3,3,62000.0,1,1,402000,317000,85000
42,5,0,20000.0,1,1,176000,150000,26000
29,3,3,55000.0,1,0,362000,305000,57000
37,11,1,90500.0,0,1,151000,148000,3000
60,4,1,1200.0,1,1,74000,77000,-3000
30,6,5,85000.0,1,1,421000,313000,108000
44,4,4,20000.0,2,1,102000,105000,-3000
62,1,4,4000.0,0,0,78000,67000,11000
42,8,1,18500.0,0,1,189000,185000,4000
36,4,1,0.0,2,1,74000,73000,1000
52,4,3,185000.0,1,1,702000,414000,288000
45,1,1,0.0,0,1,28000,27000,1000
38,4,0,14500.0,0,1,245000,214000,31000
28,1,4,0.0,1,0,160000,119000,41000
50,4,4,125000.0,1,1,683000,415000,268000
62,5,3,16500.0,1,1,221000,197000,24000
92,4,3,316700.0,1,1,1005000,427000,578000
29,3,3,822000.0,1,1,1506000,734000,772000
26,8,4,20000.0,2,0,183000,238000,-55000
31,8,5,11000.0,1,1,167000,196000,-29000
35,3,3,275200.0,1,1,342000,270000,72000
55,2,4,200000.0,1,0,904000,482000,422000
50,5,3,205000.0,2,1,408000,591000,-183000
32,4,5,42000.0,1,0,355000,421000,-66000
26,6,4,431000.0,1,0,903000,527000,376000
21,4,5,185000.0,1,1,702000,541000,161000
33,5,4,0.0,1,1,113000,107000,6000
20,4,3,160000.0,1,0,520000,368000,152000
32,9,4,0.0,0,1,75000,54000,21000
35,4,4,125000.0,1,1,374000,308000,66000
60,3,3,9000.0,1,1,268000,317000,-49000
19,3,5,12000.0,1,1,134000,153000,-19000
30,3,4,5000.0,0,0,180000,199000,-19000
60,2,3,9000.0,2,0,241000,243000,-2000
43,5,0,0.0,1,1,341000,301000,40000
26,4,4,182000.0,1,1,722000,527000,195000
45,4,0,0.0,1,1,289000,356000,-67000
54,5,2,96000.0,0,0,194000,218000,-24000
60,4,3,6000.0,1,1,180000,333000,-153000
38,5,4,40000.0,0,1,309000,232000,77000
26,3,4,0.0,2,1,180000,126000,54000
21,3,0,15200.0,1,1,66000,64000,2000
28,1,4,0.0,1,0,160000,105000,55000
40,3,3,87000.0,1,1,582000,345000,237000
40,2,1,33000.0,1,1,40000,36000,4000
36,4,4,0.0,1,1,40000,26000,14000
46,8,1,4700.0,1,1,302000,367000,-65000
30,5,2,174500.0,1,1,1412000,1045000,367000
33,4,3,564000.0,1,0,1105000,412000,693000
19,8,3,46000.0,1,1,379000,299000,80000
22,3,1,7000.0,1,1,140000,135000,5000
24,4,5,10000.0,1,1,602000,550000,52000
45,5,4,4000.0,1,1,251000,192000,59000
30,4,3,180000.0,1,1,702000,492000,210000
65,5,4,175000.0,1,1,661000,511000,150000
43,5,1,4500.0,2,0,189000,193000,-4000
22,9,3,1100000.0,1,1,1530000,551000,979000
20,4,3,200000.0,1,1,904000,527000,377000
21,1,4,0.0,1,1,119000,91000,28000
34,8,5,200000.0,1,1,763000,555000,208000
32,4,4,0.0,0,1,100000,140000,-40000
56,3,4,0.0,1,1,70000,64000,6000
48,3,1,0.0,1,1,43000,39000,4000
57,8,0,2000.0,0,1,65000,71000,-6000
71,9,2,6000.0,1,1,351000,939000,-588000
44,5,4,5500.0,0,0,208000,206000,2000
44,9,5,110000.0,2,1,613000,473000,140000
35,5,4,36500.0,2,1,178000,141000,37000
49,3,5,9000.0,1,1,297000,296000,1000
53,3,5,9000.0,1,1,402000,457000,-55000
53,4,5,100000.0,1,1,148000,213000,-65000
33,4,5,198000.0,0,0,261000,214000,47000
48,3,3,15700.0,1,1,124000,126000,-2000
65,10,4,100000.0,0,1,505000,320000,185000
39,6,4,50000.0,0,1,261000,227000,34000
80,4,4,0.0,1,1,281000,163000,118000
27,1,4,0.0,1,1,160000,103000,57000
25,4,4,360000.0,1,1,669000,368000,301000
25,5,3,62000.0,1,1,446000,546000,-100000
45,4,1,12000.0,1,1,223000,184000,39000
41,10,3,6000.0,1,1,421000,261000,160000
45,1,4,0.0,1,0,119000,95000,24000
31,2,4,180000.0,1,1,702000,431000,271000
29,4,5,52000.0,1,1,594000,435000,159000
30,3,4,180000.0,1,1,702000,421000,281000
27,3,2,2000.0,0,1,38000,30000,8000
35,4,1,15000.0,1,1,54000,48000,6000
40,4,4,0.0,2,1,93000,58000,35000
32,2,5,12000.0,1,0,82000,134000,-52000
49,4,3,142800.0,1,1,446000,736000,-290000
32,4,1,106500.0,0,1,174000,183000,-9000
60,4,4,6000.0,1,1,196000,125000,71000
18,9,4,106300.0,2,1,417000,253000,164000
37,3,3,105000.0,1,1,563000,467000,96000
25,3,0,0.0,0,1,80000,68000,12000
30,4,3,179500.0,1,1,520000,468000,52000
49,3,3,180000.0,0,1,201000,179000,22000
49,1,4,36200.0,1,1,189000,109000,80000
18,3,4,0.0,2,1,63000,37000,26000
32,8,4,0.0,2,1,100000,78000,22000
35,5,3,135000.0,1,1,343000,245000,98000
21,1,4,19500.0,0,1,31000,26000,5000
28,8,5,229500.0,0,1,482000,464000,18000
43,2,0,0.0,1,1,40000,42000,-2000
18,4,3,6000.0,2,1,189000,351000,-162000
18,5,0,5000.0,1,1,113000,101000,12000
60,3,1,0.0,1,1,193000,211000,-18000
24,3,3,210000.0,1,1,1005000,584000,421000
55,4,3,500000.0,1,1,1005000,759000,246000
42,4,4,83000.0,2,1,477000,304000,173000
36,4,2,1000.0,2,0,30000,30000,0
29,4,5,8000.0,1,1,297000,290000,7000
30,4,4,1098000.0,1,1,2812000,901000,1911000
28,5,2,12000.0,1,1,180000,189000,-9000
46,3,4,180000.0,1,1,702000,433000,269000
28,5,4,405000.0,1,0,1005000,590000,415000
36,8,4,0.0,2,1,100000,78000,22000
62,9,4,51100.0,2,1,314000,196000,118000
66,5,4,66000.0,1,1,362000,231000,131000
50,3,1,3900.0,2,1,126000,114000,12000
32,5,4,110000.0,1,1,216000,299000,-83000
40,3,4,56000.0,1,1,180000,157000,23000
58,8,4,145000.0,1,1,317000,411000,-94000
45,4,5,6000.0,2,1,160000,188000,-28000
48,4,3,160000.0,1,1,753000,394000,359000
55,4,5,300000.0,1,1,241000,201000,40000
58,4,5,199000.0,1,1,214000,234000,-20000
31,8,2,5000.0,1,1,251000,466000,-215000
35,13,3,3000.0,1,1,593000,314000,279000
37,1,4,0.0,2,1,121000,121000,0
72,4,4,192000.0,1,0,822000,564000,258000
53,3,0,0.0,1,0,139000,133000,6000
39,4,0,10000.0,1,1,176000,179000,-3000
21,4,3,206500.0,1,0,520000,449000,71000
40,4,5,5000.0,1,0,180000,164000,16000
22,4,4,41500.0,1,1,349000,214000,135000
49,5,1,41000.0,0,1,133000,116000,17000
26,8,4,97500.0,1,0,452000,340000,112000
18,3,1,0.0,1,1,64000,73000,-9000
38,4,4,100000.0,0,1,245000,220000,25000
38,4,2,5000.0,1,1,125000,178000,-53000
18,5,3,1000.0,1,1,51000,189000,-138000
43,9,4,0.0,0,1,221000,133000,88000
25,4,3,265000.0,1,0,702000,500000,202000
57,4,4,0.0,0,1,180000,119000,61000
36,8,4,0.0,0,1,226000,174000,52000
32,4,4,71000.0,1,1,446000,286000,160000
48,4,4,45000.0,0,1,121000,76000,45000
32,6,5,283000.0,1,1,904000,613000,291000
45,3,5,210000.0,1,1,763000,675000,88000
40,2,2,10000.0,1,1,374000,298000,76000
27,4,4,2000.0,1,1,89000,64000,25000
35,4,1,4000.0,2,1,74000,88000,-14000
20,4,3,68000.0,1,0,442000,206000,236000
53,4,4,300000.0,1,1,520000,365000,155000
25,3,2,1000.0,1,1,20000,14000,6000
40,3,4,0.0,2,0,68000,76000,-8000
42,2,4,32000.0,1,1,223000,191000,32000
25,8,1,38500.0,0,1,154000,129000,25000
45,3,4,60000.0,1,1,281000,172000,109000
26,5,3,69000.0,1,1,261000,209000,52000
47,3,4,0.0,2,1,38000,45000,-7000
46,5,3,680000.0,1,1,1205000,568000,637000
29,6,1,53000.0,1,0,100000,100000,0
26,4,4,0.0,0,0,201000,130000,71000
39,5,5,1500.0,1,0,219000,199000,20000
27,6,5,64800.0,1,0,718000,586000,132000
25,3,5,210000.0,1,1,462000,269000,193000
29,3,5,10000.0,1,0,446000,293000,153000
26,2,3,6000.0,1,1,90000,131000,-41000
40,3,2,17000.0,2,1,216000,174000,42000
35,5,4,75000.0,0,1,277000,161000,116000
30,9,0,0.0,1,1,201000,183000,18000
40,5,1,22000.0,1,1,131000,122000,9000
30,5,4,370000.0,1,1,803000,489000,314000
26,8,4,30000.0,2,1,253000,188000,65000
39,8,5,6000.0,1,1,314000,362000,-48000
48,4,0,0.0,1,1,121000,119000,2000
38,4,4,35000.0,0,1,301000,183000,118000
20,4,3,92000.0,1,1,578000,294000,284000
26,4,3,316000.0,1,1,967000,447000,520000
75,2,5,165000.0,0,1,777000,548000,229000
44,8,3,65100.0,1,1,251000,155000,96000
50,3,5,4000.0,2,1,134000,164000,-30000
25,5,3,225000.0,1,1,702000,206000,496000
24,3,1,44000.0,1,1,72000,73000,-1000
45,3,4,27000.0,1,1,160000,208000,-48000
43,1,2,12000.0,2,1,25000,27000,-2000
30,4,5,134000.0,1,1,442000,337000,105000
50,4,3,176000.0,1,1,663000,375000,288000
59,4,3,71650.0,1,1,442000,303000,139000
30,3,4,0.0,0,0,180000,119000,61000
36,8,1,53000.0,1,1,140000,157000,-17000
42,4,4,429500.0,1,1,1005000,735000,270000
75,4,5,3700.0,1,0,148000,172000,-24000
56,4,3,7500.0,1,1,241000,183000,58000
30,4,4,0.0,0,0,201000,131000,70000
65,6,4,181000.0,1,1,722000,406000,316000
32,5,5,400000.0,1,0,904000,682000,222000
60,4,4,115000.0,1,1,803000,503000,300000
23,5,3,48008.0,0,1,305000,352000,-47000
21,5,4,156000.0,0,1,241000,217000,24000
20,5,4,0.0,1,1,221000,158000,63000
46,8,1,6250.0,0,1,301000,217000,84000
40,1,5,9000.0,1,1,121000,152000,-31000
27,1,3,31000.0,0,1,107000,112000,-5000
20,5,3,32000.0,1,0,268000,229000,39000
29,5,4,67000.0,1,1,390000,376000,14000
55,4,5,80000.0,0,1,502000,327000,175000
42,3,3,810000.0,1,1,1305000,853000,452000
18,10,3,83000.0,2,1,371000,227000,144000
35,3,4,350000.0,1,0,702000,461000,241000
26,5,3,158000.0,1,1,804000,501000,303000
50,5,4,0.0,1,1,205000,318000,-113000
30,4,3,47000.0,1,1,195000,203000,-8000
41,3,4,27000.0,1,1,136000,105000,31000
25,6,4,91000.0,1,1,374000,228000,146000
35,4,1,3600.0,1,1,83000,85000,-2000
30,4,4,310000.0,1,0,1205000,647000,558000
70,4,1,2750.0,1,0,165000,155000,10000
24,4,3,15000.0,2,0,40000,44000,-4000
35,8,4,195000.0,2,1,391000,257000,134000
70,6,3,33000.0,1,0,134000,180000,-46000
35,5,1,0.0,1,1,121000,118000,3000
49,3,3,164800.0,1,0,892000,469000,423000
30,6,5,93000.0,0,1,358000,355000,3000
37,5,0,0.0,1,1,139000,128000,11000
58,3,4,200000.0,1,1,904000,603000,301000
50,2,4,70000.0,1,1,402000,275000,127000
35,3,0,4000.0,0,1,51000,46000,5000
38,6,4,185423.0,1,0,502000,335000,167000
26,3,0,0.0,1,1,65000,57000,8000
50,2,4,76000.0,0,1,301000,208000,93000
40,4,5,20000.0,1,1,532000,447000,85000
52,4,4,315000.0,1,1,684000,372000,312000
26,5,3,310000.0,1,1,702000,407000,295000
40,3,4,16000.0,0,1,25000,16000,9000
27,2,3,68000.0,1,1,520000,480000,40000
19,5,5,0.0,1,1,274000,282000,-8000
60,4,5,120000.0,2,1,1189000,889000,300000
33,9,5,56500.0,0,1,339000,283000,56000
30,1,1,6000.0,0,0,22000,25000,-3000
25,5,3,89000.0,1,1,602000,328000,274000
20,5,4,0.0,1,1,261000,175000,86000
42,10,4,3000.0,1,1,253000,291000,-38000
37,2,2,390000.0,1,1,643000,447000,196000
45,8,1,67000.0,0,1,317000,236000,81000
31,3,4,493000.0,1,0,1115000,727000,388000
18,1,2,9000.0,1,1,121000,172000,-51000
38,6,4,255000.0,1,0,817000,470000,347000
32,5,0,52800.0,1,1,113000,100000,13000
56,3,3,230000.0,1,1,702000,468000,234000
21,2,3,70000.0,1,0,301000,316000,-15000
31,4,3,89000.0,0,1,293000,255000,38000
32,5,5,95000.0,0,0,619000,496000,123000
30,2,0,27000.0,0,1,19000,24000,-5000
53,6,5,1000.0,0,1,15000,29000,-14000
56,4,4,450000.0,1,1,741000,613000,128000
70,5,1,10000.0,1,0,52000,44000,8000
38,3,4,139000.0,1,0,580000,423000,157000
29,6,4,0.0,1,0,126000,107000,19000
45,4,5,9000.0,1,1,446000,328000,118000
30,9,3,6000.0,1,1,64000,135000,-71000
30,3,3,3000.0,1,1,51000,36000,15000
28,1,4,0.0,1,0,301000,191000,110000
34,3,1,0.0,1,0,178000,194000,-16000
75,5,3,21000.0,1,1,241000,195000,46000
34,2,5,20000.0,2,1,125000,118000,7000
40,4,5,60000.0,1,1,702000,493000,209000
35,1,5,1000.0,1,0,162000,172000,-10000
58,5,3,6000.0,2,1,189000,370000,-181000
32,5,3,85000.0,1,1,371000,286000,85000
28,5,5,70000.0,0,1,445000,275000,170000
60,3,2,28000.0,2,1,327000,258000,69000
37,4,4,42500.0,1,1,237000,217000,20000
27,1,4,0.0,2,1,160000,115000,45000
29,5,4,72000.0,1,0,381000,230000,151000
31,4,3,43000.0,1,1,251000,238000,13000
30,2,5,3000.0,0,1,209000,172000,37000
40,3,3,456500.0,0,1,924000,620000,304000
33,5,4,0.0,0,1,180000,127000,53000
28,4,3,20000.0,1,0,289000,334000,-45000
47,5,4,13000.0,2,1,144000,119000,25000
20,8,4,20000.0,2,1,183000,153000,30000
34,5,4,180000.0,0,1,303000,211000,92000
38,6,4,365000.0,1,1,669000,424000,245000
45,5,5,9000.0,1,1,502000,320000,182000
26,9,4,220000.0,0,1,420000,252000,168000
37,3,4,465000.0,1,1,795000,473000,322000
48,3,3,33000.0,1,1,277000,141000,136000
33,3,4,0.0,2,1,241000,177000,64000
24,5,4,191000.0,1,1,817000,456000,361000
35,10,0,16600.0,0,1,428000,348000,80000
35,2,3,420000.0,1,1,1005000,675000,330000
21,5,5,105000.0,0,1,402000,402000,0
33,5,0,0.0,1,1,251000,269000,-18000
32,5,4,330000.0,2,1,560000,445000,115000
32,9,4,133000.0,1,1,522000,352000,170000
32,4,3,72000.0,1,1,434000,273000,161000
26,2,3,65000.0,1,1,301000,222000,79000
70,5,2,3000.0,1,1,100000,131000,-31000
30,5,4,10500.0,1,0,89000,82000,7000
24,3,5,29200.0,0,1,178000,225000,-47000
26,6,3,885000.0,1,0,1667000,1147000,520000
26,3,3,130000.0,1,1,502000,345000,157000
35,9,4,228500.0,1,1,520000,306000,214000
44,8,1,32500.0,0,1,321000,272000,49000
50,2,5,163000.0,2,1,163000,198000,-35000
30,4,3,89000.0,2,1,594000,259000,335000
44,8,4,363000.0,2,1,615000,386000,229000
53,8,3,120000.0,1,1,365000,449000,-84000
29,3,5,17000.0,1,1,365000,405000,-40000
40,4,3,313300.0,1,1,803000,371000,432000
56,3,4,25000.0,0,1,75000,48000,27000
20,5,3,310400.0,1,0,627000,433000,194000
20,5,3,395000.0,1,1,868000,326000,542000
24,5,3,103500.0,1,0,297000,216000,81000
26,2,4,31000.0,1,0,178000,112000,66000
24,6,1,33000.0,1,1,37000,34000,3000
29,4,4,270000.0,1,1,520000,333000,187000
38,3,4,332000.0,1,1,817000,462000,355000
48,8,4,17000.0,0,1,144000,190000,-46000
18,4,3,316700.0,1,1,1005000,377000,628000
29,5,3,322000.0,1,1,684000,362000,322000
44,3,3,332000.0,1,1,713000,393000,320000
26,3,5,160000.0,1,0,502000,328000,174000
26,4,4,0.0,0,1,140000,116000,24000
26,3,1,16000.0,2,0,80000,71000,9000
60,9,4,56500.0,2,1,528000,316000,212000
45,4,4,1027700.0,1,1,2410000,752000,1658000
22,5,4,168514.0,1,1,663000,367000,296000
70,5,4,0.0,1,0,70000,50000,20000
42,4,4,132000.0,1,1,723000,448000,275000
35,3,2,3000.0,0,1,63000,93000,-30000
30,8,4,136000.0,1,0,563000,301000,262000
30,5,4,0.0,0,1,180000,119000,61000
35,3,1,6200.0,1,1,87000,72000,15000
45,3,3,190000.0,1,1,622000,363000,259000
50,5,3,143000.0,1,1,482000,291000,191000
51,4,3,380000.0,1,0,803000,745000,58000
27,4,1,6800.0,1,0,156000,173000,-17000
53,2,3,50000.0,1,1,520000,391000,129000
25,6,1,57000.0,0,1,80000,78000,2000
23,3,3,912000.0,1,0,1054000,484000,570000
22,4,1,24500.0,1,1,118000,110000,8000
45,5,5,0.0,1,1,261000,253000,8000
55,5,1,6000.0,2,1,62000,79000,-17000
18,3,5,580000.0,1,0,342000,286000,56000
31,5,5,90000.0,0,1,452000,322000,130000
29,5,5,9000.0,1,1,446000,298000,148000
32,6,1,0.0,0,1,253000,185000,68000
56,5,5,9000.0,1,1,462000,440000,22000
50,8,4,48700.0,1,1,370000,220000,150000
36,5,1,3000.0,1,1,100000,127000,-27000
34,3,5,15000.0,1,1,100000,121000,-21000
34,3,5,60000.0,1,0,223000,242000,-19000
50,4,4,69000.0,1,0,402000,234000,168000
19,5,4,0.0,1,1,97000,72000,25000
27,4,0,0.0,1,0,100000,88000,12000
30,5,4,54000.0,0,1,321000,190000,131000
33,5,4,637000.0,2,1,545000,283000,262000
25,8,3,55000.0,2,0,241000,153000,88000
31,4,0,0.0,0,1,100000,119000,-19000
28,6,4,170000.0,0,0,283000,206000,77000
35,2,2,107000.0,1,1,194000,200000,-6000
30,1,1,0.0,2,1,20000,21000,-1000
38,4,5,55000.0,1,1,702000,451000,251000
46,3,2,260000.0,1,0,817000,560000,257000
32,3,5,95000.0,1,1,178000,177000,1000
35,3,4,110000.0,2,0,335000,208000,127000
28,4,2,2000.0,0,1,63000,70000,-7000
28,2,0,0.0,1,0,121000,106000,15000
27,4,5,7000.0,1,1,221000,179000,42000
25,6,4,165100.0,1,1,417000,253000,164000
20,4,3,55000.0,1,0,563000,482000,81000
33,3,2,2000.0,0,1,35000,27000,8000
28,4,4,0.0,0,0,160000,105000,55000
37,4,1,0.0,0,1,180000,181000,-1000
32,4,4,110000.0,2,0,304000,230000,74000
40,4,4,0.0,1,1,144000,84000,60000
34,4,4,0.0,0,1,241000,173000,68000
29,3,5,27000.0,2,1,167000,167000,0
40,4,0,0.0,1,0,63000,61000,2000
32,4,1,12000.0,1,1,148000,172000,-24000
24,5,2,249000.0,2,1,502000,570000,-68000
50,3,3,110000.0,1,1,482000,616000,-134000
35,8,3,176630.0,1,1,663000,322000,341000
50,3,4,900000.0,1,1,1606000,925000,681000
49,3,3,5000.0,1,1,193000,195000,-2000
27,5,3,4000.0,0,0,144000,145000,-1000
29,4,3,230000.0,1,1,1005000,584000,421000
29,5,3,264000.0,1,0,763000,477000,286000
25,2,5,105000.0,1,1,531000,373000,158000
35,5,4,0.0,0,1,221000,147000,74000
25,8,4,270000.0,2,1,459000,314000,145000
25,8,4,53000.0,2,1,284000,206000,78000
49,5,4,55900.0,0,1,325000,196000,129000
30,3,3,82000.0,1,1,362000,330000,32000
45,4,1,0.0,1,1,100000,112000,-12000
30,3,3,128500.0,2,1,208000,163000,45000
40,3,0,3500.0,1,1,176000,176000,0
32,8,0,3200.0,2,1,289000,333000,-44000
40,3,0,0.0,1,1,113000,106000,7000
40,4,3,42000.0,1,1,362000,167000,195000
22,4,2,1000.0,1,1,20000,19000,1000
30,4,4,186500.0,1,0,702000,402000,300000
20,4,5,78000.0,0,1,273000,202000,71000
34,4,3,428500.0,1,1,892000,491000,401000
30,4,1,5500.0,1,0,100000,94000,6000
25,2,3,26000.0,1,1,178000,177000,1000
47,5,4,284000.0,1,1,502000,656000,-154000
56,5,0,0.0,1,1,226000,265000,-39000
32,3,0,2000.0,0,0,125000,138000,-13000
80,5,5,85000.0,1,1,452000,406000,46000
70,10,1,1200.0,1,1,126000,140000,-14000
28,4,3,262000.0,1,0,723000,407000,316000
31,5,4,164000.0,1,1,627000,464000,163000
42,3,3,213500.0,1,1,520000,436000,84000
45,4,3,148500.0,1,1,371000,254000,117000
28,4,1,11500.0,0,1,201000,207000,-6000
45,3,5,3000.0,2,1,51000,47000,4000
42,4,1,2400.0,1,0,70000,78000,-8000
38,4,4,10000.0,2,1,261000,179000,82000
50,3,4,4000.0,1,1,166000,202000,-36000
38,3,2,3000.0,2,1,63000,64000,-1000
22,1,3,37000.0,1,1,201000,149000,52000
38,2,1,21420.0,1,1,74000,78000,-4000
27,2,3,180208.0,0,1,416000,515000,-99000
36,5,4,7000.0,0,0,221000,183000,38000
22,2,3,9000.0,1,1,268000,272000,-4000
55,4,2,3000.0,2,0,80000,111000,-31000
22,3,3,115000.0,0,1,294000,221000,73000
30,4,4,175000.0,2,0,362000,252000,110000
65,4,2,57000.0,1,1,251000,241000,10000
32,5,4,66000.0,1,1,362000,222000,140000
35,4,5,20000.0,2,0,90000,134000,-44000
48,6,4,690000.0,1,1,1041000,437000,604000
21,5,1,0.0,1,1,88000,83000,5000
23,5,1,2500.0,1,1,72000,67000,5000
40,3,3,16000.0,1,1,125000,120000,5000
30,2,4,0.0,2,1,71000,56000,15000
18,4,1,26500.0,0,1,150000,143000,7000
26,4,3,51000.0,0,0,148000,174000,-26000
30,4,0,0.0,2,0,151000,132000,19000
44,9,5,6000.0,0,1,381000,332000,49000
45,3,3,8000.0,1,1,214000,284000,-70000
30,3,0,0.0,1,1,75000,67000,8000
29,4,3,105000.0,1,1,321000,423000,-102000
31,3,0,0.0,0,1,71000,75000,-4000
32,4,0,0.0,1,1,124000,117000,7000
27,4,4,0.0,1,1,241000,166000,75000
28,5,3,188000.0,1,1,723000,519000,204000
42,4,4,0.0,2,1,75000,65000,10000
32,3,4,66200.0,1,1,191000,141000,50000
59,4,5,10000.0,1,1,743000,505000,238000
49,5,1,78000.0,0,1,301000,221000,80000
28,3,3,168500.0,1,1,402000,396000,6000
36,6,0,3000.0,0,1,92000,87000,5000
21,9,4,0.0,1,1,241000,206000,35000
20,5,5,160000.0,1,1,520000,345000,175000
29,4,1,4000.0,0,1,109000,106000,3000
28,4,4,83000.0,1,0,482000,644000,-162000
51,2,3,3000.0,2,1,126000,123000,3000
22,2,2,33000.0,1,1,381000,303000,78000
51,3,4,32000.0,1,1,201000,166000,35000
24,4,5,210000.0,1,1,520000,453000,67000
24,8,4,178000.0,1,1,702000,457000,245000
30,3,2,51000.0,1,1,416000,293000,123000
45,5,4,0.0,1,0,301000,217000,84000
18,4,1,0.0,1,1,144000,165000,-21000
20,5,0,13500.0,2,1,89000,79000,10000
37,4,4,76000.0,2,1,146000,112000,34000
31,3,2,8000.0,1,1,251000,319000,-68000
29,1,1,16000.0,0,1,36000,35000,1000
55,4,4,255000.0,1,1,476000,353000,123000
23,3,1,0.0,1,1,72000,76000,-4000
28,2,4,0.0,2,0,148000,140000,8000
20,3,4,0.0,1,1,141000,157000,-16000
60,2,4,110000.0,0,1,228000,135000,93000
23,5,4,50000.0,1,1,309000,220000,89000
43,3,4,46000.0,2,1,253000,165000,88000
58,8,4,575000.0,1,1,1063000,823000,240000
38,3,2,49000.0,1,1,321000,271000,50000
18,5,4,70000.0,1,1,359000,326000,33000
26,3,3,52000.0,1,1,321000,265000,56000
80,4,5,218000.0,2,0,178000,181000,-3000
38,3,3,180000.0,1,1,602000,411000,191000
36,4,1,2000.0,0,1,201000,218000,-17000
35,4,0,7000.0,2,1,100000,92000,8000
50,4,0,10000.0,1,0,176000,158000,18000
34,4,2,7000.0,2,1,251000,186000,65000
57,8,1,5000.0,1,1,364000,382000,-18000
27,4,4,43000.0,1,1,290000,217000,73000
26,5,3,417300.0,2,1,1041000,538000,503000
35,2,3,155000.0,1,1,371000,361000,10000
38,8,0,0.0,1,1,226000,188000,38000
42,5,3,57650.0,1,1,362000,265000,97000
25,10,4,21000.0,1,0,277000,238000,39000
24,3,4,56000.0,2,1,338000,214000,124000
47,4,4,229000.0,0,1,491000,552000,-61000
26,4,4,0.0,1,1,40000,26000,14000
70,4,5,8000.0,1,1,268000,241000,27000
30,4,1,2700.0,2,1,238000,173000,65000
33,5,5,579000.0,1,1,643000,612000,31000
36,2,3,80000.0,1,1,446000,308000,138000
38,9,4,108000.0,1,1,563000,365000,198000
34,3,2,10000.0,1,1,251000,194000,57000
40,4,5,110000.0,1,1,208000,169000,39000
45,5,4,300000.0,2,1,520000,432000,88000
30,5,4,5000.0,1,1,194000,125000,69000
52,4,3,5000.0,1,1,121000,126000,-5000
24,4,3,70000.0,1,0,602000,480000,122000
26,3,3,83000.0,1,0,542000,394000,148000
40,5,3,750000.0,1,1,723000,580000,143000
18,6,4,470000.0,1,1,817000,527000,290000
35,2,5,37000.0,2,1,125000,135000,-10000
18,4,4,0.0,0,1,88000,72000,16000
42,3,4,140000.0,1,1,602000,365000,237000
45,2,3,77000.0,2,1,446000,317000,129000
40,5,3,319000.0,1,1,663000,252000,411000
24,5,3,47000.0,2,0,306000,239000,67000
31,3,1,0.0,1,1,143000,176000,-33000
60,5,4,47000.0,1,1,376000,220000,156000
62,3,3,220000.0,2,1,594000,408000,186000
32,2,4,680000.0,1,0,1205000,932000,273000
32,8,4,54200.0,2,1,477000,338000,139000
47,4,3,85000.0,1,1,563000,447000,116000
18,3,1,6260.0,1,1,89000,103000,-14000
45,3,3,39000.0,1,1,356000,327000,29000
44,2,4,0.0,0,1,180000,129000,51000
40,4,1,42000.0,1,1,66000,62000,4000
28,6,1,13500.0,0,1,301000,255000,46000
32,4,1,8000.0,1,1,83000,84000,-1000
35,11,4,20000.0,1,1,203000,168000,35000
45,4,5,90000.0,1,1,446000,293000,153000
45,2,5,220000.0,1,1,702000,391000,311000
27,2,3,130000.0,1,1,502000,425000,77000
56,5,0,0.0,1,1,100000,99000,1000
43,5,1,37000.0,0,1,153000,152000,1000
26,5,4,2000.0,0,1,191000,133000,58000
35,8,2,16000.0,1,1,338000,884000,-546000
35,6,3,79040.0,0,1,143000,375000,-232000
45,4,3,53000.0,1,1,428000,595000,-167000
36,2,1,5000.0,1,1,74000,91000,-17000
36,3,0,0.0,1,1,201000,184000,17000
30,1,3,98000.0,1,1,301000,222000,79000
36,9,4,328500.0,1,1,706000,419000,287000
30,1,0,0.0,1,1,80000,72000,8000
48,4,4,0.0,1,1,301000,201000,100000
38,2,4,72000.0,1,1,442000,326000,116000
35,5,3,25000.0,1,1,152000,166000,-14000
25,4,3,6000.0,1,1,60000,71000,-11000
35,4,4,15500.0,2,1,141000,144000,-3000
35,3,0,20000.0,0,1,63000,59000,4000
40,3,2,3000.0,0,1,55000,45000,10000
54,4,3,142200.0,1,1,502000,336000,166000
38,4,4,0.0,0,1,180000,124000,56000
33,4,1,0.0,1,1,100000,101000,-1000
45,3,3,10500.0,2,1,216000,159000,57000
28,5,3,15000.0,1,1,160000,160000,0
25,4,4,180000.0,1,1,702000,473000,229000
35,4,4,0.0,1,0,201000,126000,75000
38,8,3,417300.0,2,1,1041000,537000,504000
26,4,4,0.0,0,1,180000,115000,65000
31,3,3,81000.0,1,1,535000,243000,292000
18,4,4,0.0,0,0,201000,123000,78000
35,2,1,11500.0,1,1,64000,80000,-16000
32,4,4,0.0,0,1,90000,150000,-60000
35,3,3,60235.0,0,1,381000,278000,103000
35,4,1,8700.0,1,1,140000,185000,-45000
58,2,3,118000.0,0,0,281000,205000,76000
48,5,3,350000.0,1,1,702000,366000,336000
32,4,3,195000.0,1,1,702000,489000,213000
33,3,2,5000.0,1,0,106000,110000,-4000
26,2,4,13500.0,1,0,249000,178000,71000
35,3,5,13000.0,1,1,141000,221000,-80000
44,3,0,0.0,1,1,42000,39000,3000
40,4,4,480000.0,1,1,1005000,599000,406000
32,2,4,1000.0,1,1,189000,119000,70000
32,4,3,11500.0,0,1,302000,278000,24000
39,5,5,210000.0,1,1,702000,431000,271000
29,5,3,53000.0,1,0,381000,312000,69000
42,3,3,829600.0,1,1,1783000,681000,1102000
32,3,5,217000.0,1,1,702000,509000,193000
28,8,4,69000.0,1,0,442000,338000,104000
19,4,3,235000.0,1,1,1130000,692000,438000
60,1,5,90000.0,1,1,180000,176000,4000
35,5,1,50000.0,1,1,125000,127000,-2000
19,4,3,190000.0,0,0,282000,221000,61000
48,4,3,305000.0,1,1,669000,443000,226000
21,1,4,0.0,2,1,160000,109000,51000
40,4,4,798500.0,1,1,1606000,1078000,528000
30,3,0,100000.0,2,1,51000,45000,6000
27,3,3,70000.0,1,1,362000,187000,175000
41,4,0,7000.0,1,1,251000,279000,-28000
55,4,3,215000.0,1,1,904000,540000,364000
40,5,4,0.0,1,1,80000,60000,20000
50,1,0,0.0,1,1,51000,49000,2000
31,1,0,0.0,2,0,22000,20000,2000
35,4,4,340000.0,1,1,669000,398000,271000
60,4,3,39000.0,1,1,312000,382000,-70000
45,10,3,57000.0,0,1,221000,190000,31000
45,4,4,85000.0,0,1,317000,217000,100000
50,5,5,309000.0,1,1,452000,377000,75000
34,3,1,38000.0,2,1,190000,154000,36000
23,3,4,0.0,2,1,40000,46000,-6000
30,3,4,210000.0,1,1,481000,283000,198000
35,4,3,8000.0,1,0,301000,298000,3000
22,4,4,50000.0,2,1,178000,255000,-77000
24,3,3,180000.0,1,0,602000,946000,-344000
28,4,4,100000.0,2,0,594000,371000,223000
42,3,4,6000.0,1,1,189000,119000,70000
50,8,4,0.0,2,1,281000,163000,118000
60,4,5,474500.0,1,0,967000,719000,248000
32,3,5,9000.0,1,1,301000,273000,28000
33,5,4,100000.0,1,1,301000,184000,117000
32,2,4,0.0,2,1,261000,157000,104000
45,4,0,28500.0,0,1,102000,98000,4000
37,5,4,175000.0,1,1,341000,199000,142000
28,3,4,0.0,0,1,201000,123000,78000
32,4,2,135000.0,2,1,268000,282000,-14000
34,2,1,43000.0,0,1,44000,43000,1000
35,5,1,0.0,1,1,165000,159000,6000
33,1,4,27500.0,0,1,180000,109000,71000
40,3,1,0.0,1,1,45000,44000,1000
35,5,0,46000.0,2,1,221000,250000,-29000
23,5,5,170000.0,0,1,283000,251000,32000
33,3,0,0.0,1,1,53000,47000,6000
50,2,3,65850.0,0,1,160000,258000,-98000
29,5,4,328500.0,1,0,788000,428000,360000
21,3,3,76000.0,1,1,442000,353000,89000
30,5,3,16000.0,1,1,244000,202000,42000
22,5,3,46000.0,1,1,241000,311000,-70000
20,1,4,0.0,1,1,160000,102000,58000
40,3,0,9000.0,2,1,131000,114000,17000
32,6,4,6500.0,1,0,66000,43000,23000
35,4,5,350000.0,1,1,904000,730000,174000
51,1,2,5000.0,0,0,36000,50000,-14000
45,4,1,6500.0,1,1,140000,178000,-38000
65,3,3,1075000.0,1,1,1724000,776000,948000
50,2,3,260000.0,1,1,702000,472000,230000
35,4,4,40000.0,0,1,134000,189000,-55000
24,2,3,9000.0,1,0,192000,229000,-37000
40,10,4,0.0,1,1,99000,75000,24000
30,4,3,260000.0,1,0,702000,495000,207000
18,4,0,0.0,1,0,113000,110000,3000
50,4,3,65000.0,0,0,275000,174000,101000
39,3,1,0.0,1,1,160000,163000,-3000
45,5,4,67000.0,0,1,381000,260000,121000
90,4,3,25000.0,1,1,133000,140000,-7000
28,8,2,1000.0,0,1,51000,41000,10000
30,5,5,28000.0,1,0,385000,366000,19000
42,2,1,50000.0,1,1,74000,64000,10000
60,5,4,16200.0,0,1,196000,173000,23000
37,5,4,0.0,2,0,75000,51000,24000
48,3,5,167000.0,2,1,141000,190000,-49000
27,9,4,48000.0,0,0,271000,237000,34000
30,9,2,68000.0,1,1,683000,434000,249000
38,3,2,78000.0,0,1,223000,182000,41000
35,6,4,19000.0,1,1,201000,306000,-105000
58,3,5,314000.0,1,1,218000,189000,29000
60,4,4,45000.0,2,1,332000,254000,78000
44,5,3,46000.0,1,1,241000,187000,54000
70,8,1,28000.0,0,1,151000,124000,27000
40,5,3,222000.0,1,0,576000,414000,162000
40,2,4,900000.0,1,1,1606000,778000,828000
28,3,5,18200.0,0,0,241000,205000,36000
65,3,4,47500.0,2,1,304000,195000,109000
30,4,3,8000.0,1,1,301000,285000,16000
60,3,0,7000.0,0,0,106000,96000,10000
50,4,3,42000.0,1,1,301000,274000,27000
36,1,4,0.0,1,0,160000,101000,59000
40,2,4,95000.0,1,1,371000,216000,155000
30,4,3,67000.0,1,1,388000,333000,55000
35,5,3,5000.0,0,1,169000,161000,8000
26,8,0,11000.0,0,0,304000,272000,32000
28,13,3,52000.0,1,1,231000,188000,43000
27,5,4,20500.0,0,0,137000,148000,-11000
31,4,4,63000.0,1,0,462000,269000,193000
30,5,0,1000.0,2,1,193000,185000,8000
45,5,2,3000.0,1,1,100000,75000,25000
37,3,3,9000.0,1,1,268000,331000,-63000
38,2,4,17500.0,1,1,282000,209000,73000
20,4,4,0.0,0,0,221000,132000,89000
45,5,5,287000.0,1,0,698000,469000,229000
24,4,4,58500.0,1,1,321000,212000,109000
55,8,4,17500.0,0,1,90000,74000,16000
35,4,1,3000.0,1,1,74000,65000,9000
35,5,3,435000.0,1,1,1105000,579000,526000
23,4,4,420000.0,1,1,981000,524000,457000
55,2,2,310000.0,1,1,356000,260000,96000
46,5,1,12500.0,0,0,153000,149000,4000
29,1,4,0.0,1,1,119000,89000,30000
70,4,4,0.0,1,1,124000,146000,-22000
26,3,3,52000.0,1,1,362000,278000,84000
36,8,1,13500.0,1,1,292000,258000,34000
25,3,3,195000.0,1,1,702000,459000,243000
44,3,3,130000.0,1,1,502000,383000,119000
24,3,3,320000.0,1,1,315000,229000,86000
38,2,3,41500.0,1,1,362000,293000,69000
24,2,3,860000.0,1,0,2008000,972000,1036000
26,4,2,1000.0,0,1,20000,19000,1000
45,5,1,5360.0,0,1,301000,293000,8000
29,2,2,2000.0,0,0,29000,44000,-15000
26,5,4,0.0,1,0,44000,30000,14000
41,5,4,0.0,1,1,82000,68000,14000
20,5,4,96000.0,1,1,88000,54000,34000
31,4,5,85200.0,1,1,232000,235000,-3000
36,5,3,66500.0,0,1,362000,140000,222000
53,4,5,9000.0,1,1,446000,329000,117000
26,2,5,70950.0,1,1,160000,191000,-31000
60,3,3,85000.0,1,1,563000,361000,202000
44,5,1,8000.0,1,1,80000,77000,3000
28,4,3,20600.0,2,1,292000,232000,60000
32,4,5,8000.0,1,1,297000,263000,34000
57,4,4,180000.0,1,1,381000,378000,3000
42,3,2,2000.0,0,0,38000,34000,4000
40,8,5,375000.0,0,1,753000,446000,307000
29,8,4,0.0,1,1,80000,48000,32000
25,4,1,20000.0,1,1,48000,41000,7000
55,4,3,7000.0,1,1,241000,252000,-11000
33,1,2,3000.0,0,1,21000,33000,-12000
37,4,4,100000.0,0,1,241000,184000,57000
55,2,4,260000.0,1,1,1005000,607000,398000
50,9,1,13000.0,1,1,153000,135000,18000
22,4,4,335000.0,1,1,650000,414000,236000
26,8,3,890000.0,1,1,1249000,578000,671000
27,4,1,800.0,1,0,281000,242000,39000
40,3,2,6000.0,1,1,125000,148000,-23000
35,4,3,420000.0,1,1,1005000,529000,476000
40,4,3,153500.0,1,1,371000,326000,45000
22,1,3,0.0,1,1,88000,72000,16000
25,2,3,77500.0,1,0,362000,218000,144000
80,4,4,295000.0,1,1,602000,373000,229000
48,2,4,0.0,0,1,160000,95000,65000
32,3,2,13000.0,1,1,251000,250000,1000
40,3,4,0.0,1,1,241000,157000,84000
22,3,3,590000.0,1,1,1105000,475000,630000
37,5,5,6000.0,1,1,241000,209000,32000
38,3,2,8000.0,1,1,265000,207000,58000
34,1,4,62500.0,0,1,261000,189000,72000
60,5,5,260000.0,1,0,675000,391000,284000
21,2,4,6000.0,1,1,22000,14000,8000
35,3,5,640000.0,1,1,1305000,748000,557000
31,3,4,329500.0,1,1,803000,542000,261000
36,8,0,0.0,1,1,124000,130000,-6000
21,6,3,108000.0,1,0,502000,553000,-51000
71,5,5,2000.0,0,1,180000,189000,-9000
48,4,4,163500.0,1,1,614000,361000,253000
62,4,3,330000.0,1,1,1205000,582000,623000
25,4,3,62000.0,1,1,446000,433000,13000
27,8,3,326500.0,1,1,904000,566000,338000
35,5,2,8000.0,1,0,362000,299000,63000
37,5,4,0.0,2,1,180000,117000,63000
43,6,0,8000.0,0,0,61000,55000,6000
24,8,3,5000.0,2,1,281000,174000,107000
21,2,1,6600.0,0,1,86000,88000,-2000
40,4,4,0.0,0,1,221000,145000,76000
40,4,3,260000.0,1,1,702000,468000,234000
54,8,3,56000.0,2,1,301000,280000,21000
45,3,3,55000.0,1,1,520000,405000,115000
24,4,3,76000.0,2,0,446000,349000,97000
25,5,4,30000.0,0,1,241000,151000,90000
59,5,3,267500.0,1,1,702000,423000,279000
77,4,4,10000.0,1,0,100000,64000,36000
25,4,3,8000.0,1,1,301000,279000,22000
24,8,4,60000.0,1,1,281000,241000,40000
75,3,5,10000.0,2,1,520000,429000,91000
27,3,3,1020000.0,1,1,1606000,798000,808000
20,4,3,159000.0,1,0,402000,294000,108000
42,6,5,58450.0,0,1,157000,273000,-116000
56,3,4,0.0,2,1,221000,136000,85000
28,3,1,0.0,1,1,80000,78000,2000
33,2,3,77000.0,1,1,446000,303000,143000
31,4,4,274500.0,0,1,565000,345000,220000
30,2,0,10000.0,1,1,38000,37000,1000
50,2,5,118550.0,1,1,303000,254000,49000
28,5,5,34300.0,1,1,107000,185000,-78000
45,5,4,0.0,0,1,106000,75000,31000
29,4,1,35000.0,0,1,88000,84000,4000
36,8,4,0.0,2,1,51000,43000,8000
42,5,4,139000.0,1,1,602000,328000,274000
24,4,3,33000.0,1,0,330000,248000,82000
62,9,5,260000.0,0,1,505000,434000,71000
29,3,0,0.0,2,1,207000,230000,-23000
36,1,4,0.0,2,1,160000,105000,55000
18,5,3,60000.0,0,1,194000,263000,-69000
31,12,4,31000.0,2,1,230000,166000,64000
35,2,5,8000.0,1,1,148000,132000,16000
34,9,4,130000.0,1,0,617000,396000,221000
34,4,4,248500.0,1,1,803000,508000,295000
45,2,4,0.0,1,1,119000,97000,22000
50,3,4,174000.0,1,1,639000,419000,220000
20,3,5,10000.0,2,1,594000,484000,110000
30,3,4,171000.0,1,1,614000,446000,168000
31,4,4,153000.0,2,1,402000,292000,110000
48,10,5,489000.0,2,1,1356000,957000,399000
54,3,3,13000.0,1,1,289000,232000,57000
18,3,3,5000.0,1,1,100000,100000,0
37,5,1,16000.0,1,1,151000,125000,26000
36,4,4,0.0,0,1,180000,120000,60000
60,4,3,820000.0,1,1,1205000,683000,522000
38,4,1,3800.0,1,1,83000,95000,-12000
50,1,4,0.0,1,1,119000,99000,20000
45,9,4,5000.0,0,1,264000,201000,63000
30,6,4,9200.0,1,1,22000,22000,0
32,5,3,466500.0,1,0,1005000,444000,561000
30,2,4,403500.0,1,1,904000,546000,358000
27,8,1,99500.0,1,1,185000,176000,9000
25,5,5,100000.0,2,1,892000,670000,222000
46,4,5,20000.0,1,0,702000,492000,210000
32,4,4,0.0,1,1,90000,75000,15000
53,4,3,155000.0,1,0,312000,396000,-84000
32,6,1,22000.0,1,1,148000,181000,-33000
22,4,3,50000.0,1,1,446000,485000,-39000
50,4,4,0.0,1,1,100000,74000,26000
43,5,4,140000.0,1,1,803000,521000,282000
24,4,3,50000.0,1,0,312000,277000,35000
28,8,5,31500.0,1,0,186000,208000,-22000
45,3,2,6000.0,1,1,125000,120000,5000
50,3,3,125000.0,1,1,251000,205000,46000
24,5,0,0.0,0,0,30000,40000,-10000
48,1,2,5000.0,2,1,30000,37000,-7000
43,4,5,6000.0,1,1,180000,164000,16000
60,4,3,507700.0,1,1,892000,755000,137000
34,2,1,4810.0,0,1,36000,32000,4000
26,2,4,238500.0,1,1,502000,449000,53000
60,5,2,8000.0,0,1,101000,114000,-13000
48,8,1,18000.0,0,1,402000,333000,69000
28,4,0,1000.0,1,1,113000,102000,11000
23,2,5,157500.0,1,1,669000,491000,178000
30,5,4,55000.0,2,1,178000,110000,68000
50,4,0,0.0,1,1,100000,105000,-5000
25,6,4,38000.0,1,1,221000,223000,-2000
27,2,4,82000.0,0,0,134000,107000,27000
29,5,3,7000.0,1,0,261000,208000,53000
52,4,0,0.0,1,1,121000,117000,4000
35,5,3,224000.0,1,1,1054000,674000,380000
25,3,0,0.0,1,1,88000,87000,1000
27,4,3,105000.0,1,0,502000,364000,138000
35,5,1,3300.0,1,1,70000,67000,3000
21,2,1,0.0,1,1,72000,79000,-7000
50,4,3,176000.0,1,1,663000,446000,217000
20,4,3,195000.0,1,1,702000,501000,201000
35,3,3,3000.0,2,1,60000,131000,-71000
37,4,3,195300.0,1,1,602000,594000,8000
40,4,4,180000.0,1,1,702000,456000,246000
30,8,4,429000.0,2,1,646000,376000,270000
58,3,4,0.0,0,1,63000,54000,9000
30,5,5,9000.0,2,1,446000,340000,106000
63,4,5,150000.0,1,1,743000,510000,233000
38,4,0,0.0,1,0,88000,88000,0
43,5,3,56000.0,1,1,362000,195000,167000
30,2,3,6000.0,1,1,90000,172000,-82000
48,4,5,293000.0,1,1,452000,332000,120000
20,5,1,26500.0,1,1,153000,123000,30000
28,4,3,80000.0,2,1,320000,224000,96000
26,4,4,220000.0,0,1,326000,247000,79000
30,4,0,28000.0,1,1,110000,110000,0
26,4,3,620000.0,1,1,1205000,711000,494000
40,9,0,0.0,1,1,246000,232000,14000
35,3,5,33000.0,1,0,194000,173000,21000
20,3,4,0.0,0,1,88000,56000,32000
65,4,5,5000.0,1,1,139000,168000,-29000
50,4,4,0.0,0,1,180000,116000,64000
36,4,4,54000.0,1,1,314000,214000,100000
21,4,4,900000.0,1,1,1606000,661000,945000
29,5,3,7000.0,0,1,289000,221000,68000
27,9,3,14000.0,1,1,160000,275000,-115000
29,3,4,0.0,1,1,261000,154000,107000
35,6,3,51500.0,1,1,340000,262000,78000
42,4,5,9000.0,1,1,442000,322000,120000
42,5,3,47000.0,1,1,358000,304000,54000
28,8,4,481000.0,1,1,1286000,751000,535000
35,3,3,95000.0,1,1,362000,184000,178000
30,8,3,13000.0,2,1,144000,232000,-88000
19,3,4,31000.0,1,1,119000,98000,21000
35,5,3,203400.0,1,1,446000,347000,99000
30,3,3,8000.0,1,1,227000,187000,40000
39,3,0,0.0,1,1,160000,162000,-2000
28,4,3,7000.0,1,1,251000,191000,60000
32,8,3,52000.0,1,1,326000,345000,-19000
43,6,4,12000.0,1,1,201000,187000,14000
18,4,3,130000.0,1,1,371000,337000,34000
31,2,5,60000.0,1,1,297000,269000,28000
33,5,4,37000.0,1,1,89000,66000,23000
31,5,3,350000.0,1,1,624000,354000,270000
22,5,3,261600.0,2,1,699000,276000,423000
36,1,1,0.0,1,1,24000,24000,0
50,4,3,6000.0,1,1,180000,433000,-253000
27,10,1,94000.0,1,1,586000,409000,177000
33,4,4,5000.0,0,1,192000,163000,29000
25,3,4,0.0,0,1,180000,106000,74000
40,4,4,95000.0,1,1,371000,410000,-39000
28,6,4,429000.0,1,1,788000,444000,344000
22,5,4,48500.0,1,1,362000,232000,130000
35,10,4,90000.0,1,1,341000,573000,-232000
30,4,5,49000.0,1,0,442000,315000,127000
28,2,1,0.0,1,1,58000,75000,-17000
40,4,4,18200.0,0,1,269000,456000,-187000
47,6,1,0.0,0,1,221000,188000,33000
43,4,0,35000.0,1,1,140000,151000,-11000
45,9,1,4000.0,1,1,22000,19000,3000
70,6,5,1000.0,1,1,48000,81000,-33000
35,3,5,6000.0,1,1,125000,111000,14000
21,4,4,0.0,1,0,80000,56000,24000
55,2,3,305000.0,1,1,702000,416000,286000
30,5,3,46000.0,1,1,326000,415000,-89000
32,3,4,0.0,0,0,180000,112000,68000
58,3,1,31500.0,1,1,153000,180000,-27000
34,8,4,135000.0,0,1,481000,284000,197000
60,11,2,3000.0,1,1,180000,275000,-95000
22,1,4,0.0,1,1,281000,193000,88000
30,3,1,0.0,0,1,180000,167000,13000
56,1,4,20000.0,0,1,90000,78000,12000
23,3,4,63000.0,1,1,241000,143000,98000
28,2,1,100000.0,2,0,89000,110000,-21000
32,4,4,36500.0,0,1,138000,205000,-67000
22,4,5,19500.0,1,1,304000,277000,27000
38,9,4,326000.0,0,1,538000,311000,227000
52,11,4,60000.0,1,1,552000,294000,258000
30,4,3,59000.0,1,1,270000,320000,-50000
25,4,3,21200.0,1,1,268000,218000,50000
46,4,4,0.0,1,1,140000,97000,43000
48,4,4,549000.0,1,1,1305000,709000,596000
33,5,3,56000.0,1,1,241000,182000,59000
40,4,4,12000.0,0,1,18000,16000,2000
39,8,4,45000.0,2,1,225000,158000,67000
30,3,4,0.0,1,0,160000,107000,53000
52,5,2,9000.0,1,1,627000,512000,115000
57,4,2,380000.0,1,1,1205000,1288000,-83000
50,2,2,110000.0,1,0,393000,284000,109000
37,4,4,69000.0,1,1,402000,451000,-49000
56,2,4,198500.0,1,1,502000,363000,139000
85,2,0,0.0,0,0,36000,34000,2000
36,3,3,30000.0,1,1,193000,430000,-237000
48,9,4,300000.0,2,1,524000,343000,181000
26,4,3,50000.0,1,1,253000,226000,27000
30,4,4,0.0,0,1,301000,203000,98000
26,3,0,0.0,1,1,121000,102000,19000
21,8,4,3000.0,1,1,254000,283000,-29000
55,4,2,5000.0,1,1,124000,151000,-27000
45,10,5,150000.0,1,1,984000,722000,262000
29,4,4,0.0,0,1,119000,107000,12000
34,4,5,9000.0,2,1,446000,384000,62000
35,9,4,53000.0,0,1,362000,215000,147000
60,1,5,10000.0,0,1,180000,130000,50000
49,3,5,60000.0,1,1,119000,126000,-7000
45,4,2,5000.0,1,1,125000,147000,-22000
65,4,3,62000.0,1,1,292000,315000,-23000
42,3,2,3000.0,2,1,58000,72000,-14000
32,2,4,0.0,1,1,60000,98000,-38000
26,3,3,3000.0,1,1,63000,58000,5000
36,5,2,30000.0,1,1,2595000,1074000,1521000
22,5,4,210000.0,1,1,535000,449000,86000
28,1,4,0.0,0,1,261000,163000,98000
55,5,3,526500.0,1,1,1005000,468000,537000
36,13,4,77000.0,0,0,482000,310000,172000
52,11,1,1000.0,1,1,341000,285000,56000
36,2,1,30500.0,2,1,121000,111000,10000
46,3,4,137000.0,1,1,535000,296000,239000
21,3,1,27000.0,1,1,128000,110000,18000
32,3,0,0.0,1,0,160000,144000,16000
51,5,1,2000.0,0,0,60000,72000,-12000
36,4,2,58000.0,1,1,251000,205000,46000
30,5,1,0.0,1,1,301000,265000,36000
33,8,4,19700.0,1,1,284000,205000,79000
32,4,3,234000.0,1,1,1041000,1102000,-61000
58,5,4,20000.0,0,1,241000,162000,79000
40,8,2,68000.0,0,1,643000,487000,156000
65,3,0,0.0,1,1,124000,121000,3000
27,5,4,79000.0,2,0,315000,284000,31000
26,3,5,132500.0,1,1,402000,354000,48000
27,1,2,4000.0,2,1,27000,38000,-11000
34,3,1,0.0,1,1,144000,171000,-27000
35,2,3,710000.0,1,1,1606000,868000,738000
60,1,4,0.0,2,1,42000,30000,12000
65,2,5,39300.0,0,1,219000,181000,38000
63,3,1,100000.0,0,1,58000,48000,10000
40,4,3,58000.0,1,1,301000,184000,117000
48,5,0,0.0,1,1,176000,181000,-5000
23,4,3,6000.0,1,1,169000,152000,17000
82,2,3,735000.0,1,1,1189000,784000,405000
37,4,1,10000.0,1,1,140000,174000,-34000
64,8,0,0.0,0,1,163000,156000,7000
22,3,4,10000.0,2,1,80000,121000,-41000
38,5,4,623000.0,1,1,1606000,941000,665000
37,5,1,5000.0,1,1,104000,99000,5000
54,3,3,6500.0,1,1,125000,154000,-29000
46,2,4,320000.0,1,1,402000,366000,36000
31,4,4,160000.0,1,0,520000,308000,212000
26,4,2,73000.0,1,1,88000,70000,18000
30,4,4,199000.0,1,1,892000,536000,356000
25,5,4,0.0,1,0,113000,107000,6000
18,5,0,0.0,1,1,376000,319000,57000
28,5,5,70000.0,1,0,362000,293000,69000
23,3,3,210000.0,2,0,446000,200000,246000
36,4,3,206000.0,1,1,879000,579000,300000
25,8,1,25000.0,0,1,151000,146000,5000
20,5,0,27000.0,1,1,314000,391000,-77000
23,5,0,5000.0,1,1,88000,94000,-6000
34,3,3,350000.0,1,1,702000,405000,297000
38,4,3,6000.0,2,1,161000,219000,-58000
38,2,4,81500.0,1,1,376000,230000,146000
27,2,4,45000.0,1,1,163000,149000,14000
35,5,3,300600.0,1,1,1005000,545000,460000
49,3,3,26000.0,1,1,121000,112000,9000
27,3,4,0.0,0,1,180000,124000,56000
25,4,4,0.0,1,1,70000,49000,21000
34,5,0,0.0,1,0,124000,133000,-9000
54,4,4,0.0,0,1,75000,66000,9000
52,4,0,0.0,1,1,251000,270000,-19000
53,4,1,3000.0,1,1,74000,69000,5000
32,5,5,1500.0,1,1,244000,225000,19000
28,4,4,182000.0,1,1,520000,299000,221000
31,5,1,12000.0,1,1,89000,112000,-23000
45,3,3,3000.0,0,1,63000,49000,14000
18,3,1,0.0,1,1,100000,85000,15000
42,3,4,0.0,2,1,63000,57000,6000
31,4,4,10000.0,1,1,100000,88000,12000
25,9,1,6650.0,0,1,301000,296000,5000
26,2,5,9000.0,1,1,193000,171000,22000
19,5,3,374000.0,1,1,1085000,703000,382000
34,11,4,0.0,0,1,75000,56000,19000
35,4,3,11000.0,1,1,169000,157000,12000
30,3,5,0.0,2,1,121000,93000,28000
52,3,3,50000.0,1,1,63000,126000,-63000
27,9,4,0.0,1,0,201000,154000,47000
24,8,3,37000.0,0,0,241000,181000,60000
20,3,2,1000.0,0,1,24000,20000,4000
27,3,2,3000.0,2,1,60000,73000,-13000
25,4,0,15000.0,1,1,84000,75000,9000
29,2,4,0.0,2,1,106000,162000,-56000
35,5,4,20000.0,1,1,121000,196000,-75000
30,3,4,0.0,2,1,40000,38000,2000
38,2,3,356500.0,1,0,892000,444000,448000
25,3,4,9200.0,2,0,141000,87000,54000
40,5,4,83000.0,1,1,563000,358000,205000
57,4,4,135000.0,1,1,476000,338000,138000
30,3,4,9000.0,2,1,140000,89000,51000
30,6,4,175000.0,1,1,661000,374000,287000
35,5,3,287000.0,1,1,721000,441000,280000
40,4,1,9500.0,0,1,160000,144000,16000
23,3,5,14000.0,2,1,223000,214000,9000
70,3,3,612000.0,1,1,1330000,507000,823000
33,5,4,0.0,2,1,113000,85000,28000
42,9,3,225000.0,1,1,753000,470000,283000
45,4,3,532100.0,1,1,1330000,574000,756000
40,1,4,25000.0,1,1,134000,81000,53000
27,8,0,0.0,1,1,176000,155000,21000
33,3,2,1000.0,0,1,5000,5000,0
18,4,1,0.0,1,1,104000,90000,14000
23,4,3,180000.0,1,1,602000,470000,132000
37,5,3,59000.0,1,1,494000,525000,-31000
32,1,4,0.0,0,0,121000,79000,42000
48,3,3,105000.0,1,1,502000,323000,179000
20,2,0,0.0,1,1,121000,107000,14000
19,4,4,0.0,1,0,113000,107000,6000
47,5,5,6000.0,0,1,213000,204000,9000
25,5,1,9000.0,0,0,72000,71000,1000
48,4,3,10500.0,0,1,273000,268000,5000
46,3,0,0.0,2,1,55000,54000,1000
31,4,4,65000.0,1,0,160000,187000,-27000
26,1,0,3000.0,0,1,15000,13000,2000
46,4,3,84000.0,1,1,502000,511000,-9000
26,9,1,31500.0,1,0,183000,211000,-28000
47,3,2,74900.0,1,0,241000,184000,57000
38,4,3,865000.0,1,1,1707000,1183000,524000
44,4,1,54000.0,1,1,112000,100000,12000
35,5,5,217500.0,1,1,702000,401000,301000
20,1,4,0.0,1,1,160000,108000,52000
18,4,4,180000.0,0,1,289000,192000,97000
33,4,3,250000.0,2,1,669000,423000,246000
32,3,3,93000.0,2,1,402000,165000,237000
65,5,3,4000.0,1,1,113000,137000,-24000
35,4,3,185000.0,1,1,723000,472000,251000
26,2,3,384000.0,1,0,1105000,659000,446000
21,3,3,90000.0,0,0,602000,404000,198000
46,5,2,378500.0,1,1,892000,633000,259000
40,3,4,0.0,0,1,100000,81000,19000
38,4,4,0.0,1,1,241000,160000,81000
30,3,3,88000.0,1,0,469000,325000,144000
37,5,4,66000.0,2,1,365000,253000,112000
70,5,4,68000.0,1,1,402000,235000,167000
20,3,2,3000.0,0,1,60000,46000,14000
58,9,4,95000.0,0,1,256000,183000,73000
28,8,5,125000.0,0,1,615000,441000,174000
29,5,0,14000.0,2,1,107000,98000,9000
30,6,4,189000.0,1,0,807000,587000,220000
35,4,3,165500.0,1,1,376000,499000,-123000
24,4,3,180000.0,1,0,702000,447000,255000
32,3,4,0.0,0,0,151000,122000,29000
58,2,1,36000.0,1,1,80000,70000,10000
23,4,3,510000.0,1,1,904000,462000,442000
30,3,4,0.0,1,1,251000,147000,104000
30,6,3,5000.0,1,1,196000,237000,-41000
42,5,4,4000.0,1,1,140000,113000,27000
22,8,0,20000.0,1,1,226000,261000,-35000
26,4,4,4000.0,0,1,248000,158000,90000
50,4,4,10500.0,1,1,65000,60000,5000
47,3,3,75000.0,1,1,502000,322000,180000
38,2,4,0.0,1,1,72000,53000,19000
52,5,4,14000.0,2,1,292000,196000,96000
35,1,4,0.0,1,1,160000,106000,54000
46,4,5,8000.0,1,1,297000,293000,4000
34,4,1,15000.0,1,0,119000,159000,-40000
22,4,3,230000.0,1,1,702000,500000,202000
35,3,3,311100.0,2,1,669000,204000,465000
70,5,1,16000.0,0,1,163000,139000,24000
32,5,0,5000.0,0,1,125000,153000,-28000
30,8,0,46000.0,2,1,306000,259000,47000
22,3,0,3000.0,0,1,34000,31000,3000
30,5,0,36000.0,2,1,211000,210000,1000
38,4,3,130000.0,1,1,502000,531000,-29000
32,3,1,5000.0,1,1,100000,131000,-31000
37,5,1,0.0,0,1,253000,206000,47000
21,9,3,106000.0,1,1,297000,338000,-41000
25,5,4,90000.0,1,1,450000,397000,53000
28,1,4,0.0,1,0,134000,102000,32000
18,6,4,0.0,0,1,180000,123000,57000
35,4,4,367000.0,1,1,684000,387000,297000
19,4,0,10000.0,1,1,51000,45000,6000
18,4,3,144000.0,1,1,371000,213000,158000
29,5,4,155000.0,1,1,520000,301000,219000
29,3,3,230000.0,1,1,702000,537000,165000
57,5,4,15000.0,1,1,48000,30000,18000
25,6,1,10000.0,1,1,140000,116000,24000
28,4,1,50000.0,1,0,251000,183000,68000
27,4,3,6000.0,1,0,169000,153000,16000
45,4,4,86000.0,1,1,526000,373000,153000
38,5,4,0.0,1,1,100000,146000,-46000
46,11,0,0.0,1,1,226000,206000,20000
34,4,3,165000.0,0,1,753000,485000,268000
31,3,4,498600.0,1,1,1005000,622000,383000
18,5,5,229500.0,1,0,520000,377000,143000
20,8,4,0.0,0,1,100000,79000,21000
42,3,4,495500.0,1,1,1005000,594000,411000
28,2,0,0.0,1,1,160000,148000,12000
26,8,0,0.0,1,1,60000,56000,4000
32,4,4,71000.0,1,1,321000,322000,-1000
30,5,3,20000.0,1,1,241000,244000,-3000
26,8,3,103400.0,1,1,376000,217000,159000
32,2,3,85000.0,1,1,502000,357000,145000
39,4,3,153500.0,1,1,371000,493000,-122000
23,3,5,105000.0,1,1,371000,372000,-1000
33,3,4,160000.0,1,0,452000,280000,172000
35,3,4,756000.0,1,1,2008000,680000,1328000
60,4,3,114000.0,1,1,301000,187000,114000
88,5,0,0.0,1,1,139000,135000,4000
70,3,0,0.0,2,1,58000,54000,4000
50,8,0,6400.0,2,1,307000,278000,29000
32,1,2,4000.0,0,1,26000,30000,-4000
30,3,4,90000.0,2,1,180000,127000,53000
50,8,3,174000.0,1,1,663000,367000,296000
19,8,0,5000.0,0,0,125000,155000,-30000
52,3,2,14200.0,2,1,320000,275000,45000
33,5,0,1700.0,2,1,75000,81000,-6000
28,3,3,185000.0,1,1,663000,366000,297000
26,3,4,480000.0,1,0,1005000,597000,408000
29,4,3,45000.0,1,1,362000,445000,-83000
25,5,1,5000.0,0,1,75000,73000,2000
45,9,4,210000.0,2,1,540000,306000,234000
32,6,1,20000.0,1,0,201000,190000,11000
40,4,4,0.0,0,1,201000,118000,83000
38,5,5,43200.0,0,1,178000,178000,0
24,3,3,39000.0,1,1,362000,264000,98000
30,4,1,17500.0,2,1,76000,71000,5000
64,2,4,900000.0,1,1,1606000,930000,676000
33,5,4,7500.0,0,0,154000,148000,6000
18,4,0,2000.0,1,1,65000,57000,8000
35,9,5,26000.0,0,1,275000,251000,24000
35,5,1,0.0,0,1,160000,139000,21000
60,1,4,0.0,2,1,180000,106000,74000
40,3,4,775000.0,1,1,1005000,536000,469000
58,3,3,15000.0,2,0,63000,43000,20000
30,9,4,96000.0,0,1,362000,227000,135000
49,5,4,16500.0,1,1,268000,180000,88000
32,3,2,1000.0,2,1,30000,38000,-8000
50,3,5,3000.0,0,1,51000,91000,-40000
25,3,3,150000.0,1,1,321000,232000,89000
22,5,5,150000.0,1,1,421000,381000,40000
26,5,4,137000.0,1,1,563000,391000,172000
46,5,0,28500.0,0,1,151000,157000,-6000
21,3,4,0.0,2,1,106000,65000,41000
32,4,4,210000.0,1,1,520000,423000,97000
30,4,4,65000.0,0,1,376000,261000,115000
18,8,3,22000.0,1,1,251000,201000,50000
45,3,1,6000.0,1,1,90000,98000,-8000
64,5,1,1500.0,1,1,267000,209000,58000
25,2,5,153000.0,1,1,371000,316000,55000
31,4,3,310000.0,1,1,904000,382000,522000
45,5,1,12000.0,1,1,306000,285000,21000
35,4,1,18000.0,1,0,65000,80000,-15000
32,3,4,0.0,1,0,201000,139000,62000
32,5,4,0.0,0,0,51000,32000,19000
30,2,5,20000.0,2,1,104000,99000,5000
32,5,4,0.0,0,1,180000,123000,57000
23,3,4,0.0,2,1,45000,57000,-12000
33,5,3,2000.0,1,1,253000,165000,88000
28,5,4,0.0,0,0,100000,74000,26000
35,5,2,276500.0,0,1,442000,290000,152000
30,9,1,0.0,2,1,66000,78000,-12000
58,5,1,126500.0,1,1,191000,163000,28000
18,4,3,860000.0,1,1,1305000,864000,441000
34,3,4,260000.0,1,1,520000,350000,170000
32,5,4,70000.0,2,1,205000,216000,-11000
29,4,4,0.0,2,0,223000,261000,-38000
30,5,3,75000.0,1,1,371000,353000,18000
35,4,4,498000.0,1,1,1005000,576000,429000
30,5,3,180000.0,1,1,702000,456000,246000
60,8,4,206000.0,1,1,417000,278000,139000
28,4,4,480000.0,1,1,1005000,600000,405000
28,4,4,180000.0,1,0,702000,407000,295000
35,3,5,210000.0,1,1,702000,517000,185000
20,4,2,8000.0,1,1,251000,250000,1000
22,5,3,230000.0,1,1,1005000,608000,397000
27,3,3,86000.0,1,1,520000,892000,-372000
70,6,5,45000.0,2,1,372000,323000,49000
40,4,2,10000.0,1,1,1406000,967000,439000
21,4,2,2000.0,1,1,63000,49000,14000
34,4,0,0.0,1,1,201000,189000,12000
25,3,3,88000.0,1,0,524000,385000,139000
45,4,2,8000.0,1,1,251000,187000,64000
30,2,3,302500.0,1,0,1005000,614000,391000
52,4,3,52000.0,1,1,371000,279000,92000
29,6,4,0.0,1,1,208000,214000,-6000
32,3,4,340000.0,1,1,702000,412000,290000
31,1,4,0.0,1,1,63000,37000,26000
38,3,3,16000.0,2,1,208000,175000,33000
20,5,3,180000.0,1,1,602000,455000,147000
30,4,3,280000.0,1,1,602000,500000,102000
34,3,5,55000.0,1,0,803000,611000,192000
40,4,5,50000.0,0,1,555000,381000,174000
30,3,4,0.0,2,0,261000,173000,88000
49,5,4,206000.0,1,1,506000,321000,185000
19,8,4,237000.0,1,0,874000,469000,405000
74,2,3,65000.0,1,1,301000,184000,117000
29,5,3,75000.0,0,1,495000,405000,90000
40,2,1,6300.0,2,1,60000,69000,-9000
29,8,1,35000.0,0,0,250000,287000,-37000
25,3,4,0.0,2,0,88000,58000,30000
28,4,3,51500.0,1,1,402000,342000,60000
53,3,1,0.0,1,0,65000,53000,12000
38,5,0,44000.0,0,1,281000,286000,-5000
45,2,2,43000.0,1,1,134000,168000,-34000
46,3,1,0.0,2,1,30000,38000,-8000
28,3,5,39320.0,2,1,142000,183000,-41000
19,8,3,6000.0,1,1,301000,260000,41000
25,5,1,0.0,0,1,121000,118000,3000
23,9,3,15000.0,0,1,180000,318000,-138000
71,11,3,22000.0,0,1,269000,232000,37000
34,9,3,14000.0,0,1,160000,394000,-234000
27,4,3,5000.0,0,0,121000,183000,-62000
50,4,4,0.0,0,1,80000,110000,-30000
48,4,2,4000.0,1,1,89000,104000,-15000
48,4,1,0.0,0,1,60000,54000,6000
36,9,2,2000.0,0,1,118000,131000,-13000
55,5,4,0.0,2,1,121000,150000,-29000
42,4,2,5000.0,0,1,128000,141000,-13000
24,3,3,11000.0,0,1,144000,156000,-12000
34,4,0,500.0,1,1,160000,156000,4000
18,5,3,21000.0,1,1,201000,286000,-85000
61,5,3,5000.0,1,1,180000,257000,-77000
50,8,3,2000.0,1,1,301000,234000,67000
22,4,1,1000.0,1,1,180000,184000,-4000
32,5,3,5000.0,0,1,160000,233000,-73000
22,4,4,0.0,0,1,70000,45000,25000
38,9,4,0.0,0,0,121000,90000,31000
20,5,3,5000.0,1,1,169000,272000,-103000
41,5,4,0.0,2,1,70000,115000,-45000
24,15,3,13000.0,1,1,169000,169000,0
19,5,3,3000.0,2,1,90000,239000,-149000
24,8,3,311700.0,1,1,702000,348000,354000
45,8,3,9000.0,0,1,100000,229000,-129000
30,4,3,89000.0,1,0,492000,312000,180000
24,4,3,150000.0,1,1,663000,408000,255000
19,5,3,120000.0,1,1,573000,414000,159000
51,4,3,65000.0,1,1,381000,317000,64000
28,5,3,96000.0,1,1,582000,451000,131000
26,5,3,170000.0,1,1,693000,472000,221000
50,4,3,8000.0,1,1,301000,239000,62000
31,5,3,74000.0,1,1,542000,450000,92000
28,5,3,109000.0,1,1,502000,359000,143000
30,1,4,0.0,1,1,201000,133000,68000
24,3,4,0.0,1,1,60000,37000,23000
18,3,3,2000.0,1,1,40000,43000,-3000
40,3,5,2000.0,1,1,40000,49000,-9000
38,1,4,0.0,1,0,60000,63000,-3000
29,3,4,67000.0,1,0,362000,237000,125000
34,4,4,0.0,1,1,60000,67000,-7000
36,3,4,0.0,1,1,51000,64000,-13000
40,3,4,0.0,0,1,40000,35000,5000
45,5,3,5000.0,0,1,171000,269000,-98000
38,3,2,3000.0,0,1,51000,61000,-10000
37,4,0,0.0,0,1,30000,32000,-2000
50,5,0,0.0,0,0,20000,25000,-5000
40,4,0,0.0,0,1,20000,25000,-5000
32,3,2,3000.0,0,1,51000,50000,1000
35,4,0,0.0,0,1,20000,21000,-1000
30,4,1,0.0,0,1,30000,37000,-7000
35,4,1,0.0,0,1,20000,26000,-6000
65,5,0,0.0,0,1,40000,48000,-8000
62,13,1,0.0,1,1,160000,165000,-5000
68,9,4,8500.0,0,0,121000,88000,33000
24,8,4,0.0,0,1,80000,57000,23000
45,3,2,5000.0,0,0,89000,134000,-45000
33,3,2,5000.0,0,0,89000,103000,-14000
42,5,1,0.0,0,1,121000,112000,9000
27,5,3,3000.0,1,0,90000,76000,14000
49,5,3,4000.0,0,1,121000,74000,47000
40,9,5,1000.0,1,1,72000,121000,-49000
38,4,1,0.0,0,1,70000,60000,10000
22,5,5,0.0,1,1,20000,18000,2000
45,3,0,0.0,1,0,70000,70000,0
48,9,2,1000.0,1,1,24000,19000,5000
25,4,4,0.0,0,0,60000,39000,21000
60,5,3,84000.0,1,0,502000,370000,132000
55,4,2,3000.0,0,1,72000,67000,5000
52,5,5,5000.0,1,1,180000,217000,-37000
47,5,5,0.0,0,1,171000,178000,-7000
21,9,3,4000.0,1,0,259000,173000,86000
23,5,4,0.0,1,1,133000,99000,34000
30,5,4,0.0,1,1,204000,119000,85000
50,8,4,0.0,1,1,169000,134000,35000
31,4,1,0.0,1,1,142000,125000,17000
28,4,4,0.0,1,1,191000,141000,50000
45,5,4,0.0,1,1,138000,155000,-17000
48,4,3,14600.0,0,1,285000,243000,42000
27,1,0,0.0,1,1,24000,26000,-2000
22,3,0,0.0,1,1,121000,100000,21000
22,1,0,0.0,1,1,24000,23000,1000
47,1,2,8000.0,0,1,70000,60000,10000
30,1,5,0.0,1,1,90000,82000,8000
33,1,2,10000.0,1,1,191000,254000,-63000
32,1,0,0.0,1,1,24000,30000,-6000
51,3,0,0.0,1,1,78000,70000,8000
30,1,0,0.0,1,1,60000,58000,2000
48,1,2,10000.0,1,1,653000,548000,105000
28,3,4,0.0,1,0,301000,199000,102000
30,4,5,9000.0,0,1,502000,351000,151000
38,1,2,8000.0,2,1,80000,77000,3000
30,1,3,84000.0,0,1,490000,380000,110000
58,1,2,8000.0,2,1,80000,108000,-28000
23,1,3,85000.0,2,1,502000,317000,185000
30,1,2,8000.0,2,1,80000,74000,6000
25,1,2,9000.0,2,1,90000,121000,-31000
48,3,2,6000.0,0,1,144000,165000,-21000
28,1,0,0.0,2,1,60000,53000,7000
23,5,4,187000.0,1,1,771000,478000,293000
60,8,1,0.0,0,1,127000,121000,6000
35,1,2,10000.0,1,1,140000,156000,-16000
61,1,5,0.0,0,0,40000,49000,-9000
43,1,2,7000.0,1,1,58000,48000,10000
32,1,4,0.0,0,1,40000,32000,8000
38,8,5,9000.0,1,0,1032000,668000,364000
19,5,2,2000.0,1,1,58000,49000,9000
30,5,4,0.0,0,1,60000,45000,15000
35,5,4,0.0,2,0,60000,40000,20000
25,5,2,2000.0,0,1,58000,74000,-16000
55,1,2,8000.0,2,1,80000,95000,-15000
18,1,2,8000.0,2,1,72000,101000,-29000
45,1,2,9000.0,2,0,100000,124000,-24000
25,1,2,8000.0,2,0,80000,84000,-4000
18,1,2,9000.0,2,0,100000,153000,-53000
20,3,3,8000.0,2,0,241000,186000,55000
34,1,2,9000.0,2,0,90000,100000,-10000
45,1,2,8000.0,2,1,80000,99000,-19000
22,8,3,82000.0,0,1,502000,319000,183000
23,1,4,0.0,0,1,44000,32000,12000
43,3,4,0.0,0,1,44000,39000,5000
32,1,4,0.0,0,1,51000,37000,14000
30,1,2,8000.0,1,1,72000,75000,-3000
51,3,4,0.0,0,1,57000,43000,14000
42,1,5,7000.0,0,1,57000,86000,-29000
38,8,0,0.0,1,1,219000,222000,-3000
35,9,0,0.0,1,1,438000,372000,66000
25,1,2,9000.0,2,0,100000,158000,-58000
35,1,2,10000.0,1,1,144000,156000,-12000
24,1,4,0.0,0,1,151000,111000,40000
30,1,3,0.0,1,1,86000,80000,6000
28,1,2,9000.0,2,1,100000,108000,-8000
40,3,4,0.0,0,1,207000,130000,77000
47,5,3,67000.0,1,1,396000,293000,103000
30,1,2,8000.0,1,1,80000,114000,-34000
28,1,2,8000.0,2,0,80000,105000,-25000
20,1,3,85000.0,0,0,502000,321000,181000
36,4,2,2000.0,1,1,51000,41000,10000
40,1,5,6000.0,0,1,40000,68000,-28000
65,1,2,7000.0,1,1,51000,48000,3000
36,1,2,8000.0,2,1,80000,90000,-10000
29,1,2,6000.0,1,1,48000,49000,-1000
32,3,2,6000.0,2,1,144000,147000,-3000
20,1,2,9000.0,2,1,100000,161000,-61000
50,1,2,8000.0,2,1,72000,68000,4000
33,1,2,8000.0,2,1,80000,95000,-15000
35,3,5,1010000.0,0,1,622000,403000,219000
28,1,4,0.0,0,0,151000,157000,-6000
30,1,2,9000.0,2,0,90000,145000,-55000
55,1,4,0.0,0,0,46000,35000,11000
33,1,2,18500.0,1,0,48000,59000,-11000
51,1,2,8000.0,2,0,72000,70000,2000
23,1,3,10000.0,0,0,241000,179000,62000
31,5,2,1000.0,1,1,48000,43000,5000
20,1,4,0.0,0,1,44000,30000,14000
50,3,3,37000.0,2,1,221000,117000,104000
27,4,2,2000.0,2,0,58000,47000,11000
50,8,2,1000.0,1,1,58000,50000,8000
26,8,1,0.0,1,0,299000,367000,-68000
30,1,2,56000.0,2,1,72000,75000,-3000
30,1,2,8000.0,2,1,80000,101000,-21000
22,5,5,9000.0,1,1,542000,370000,172000
28,1,2,9000.0,2,1,100000,92000,8000
32,1,2,8000.0,2,1,80000,78000,2000
31,1,3,10000.0,0,1,301000,223000,78000
50,4,3,34000.0,0,1,317000,237000,80000
52,1,2,8000.0,2,0,80000,83000,-3000
42,3,3,85000.0,1,1,502000,396000,106000
29,1,3,10000.0,0,0,241000,194000,47000
40,1,3,10000.0,2,1,241000,201000,40000
43,5,4,6000.0,0,1,201000,131000,70000
44,1,2,6000.0,1,0,48000,45000,3000
50,4,4,0.0,0,0,44000,30000,14000
30,1,4,0.0,0,0,44000,38000,6000
32,1,5,0.0,0,1,151000,136000,15000
55,1,2,8000.0,0,1,72000,79000,-7000
32,8,2,1000.0,1,1,58000,46000,12000
30,3,3,8000.0,2,1,241000,181000,60000
34,5,2,2000.0,1,1,58000,60000,-2000
46,1,4,13000.0,2,1,51000,36000,15000
22,1,5,0.0,0,1,51000,68000,-17000
22,5,2,9000.0,1,1,442000,318000,124000
32,8,2,1000.0,1,1,68000,73000,-5000
32,3,5,2000.0,2,1,44000,60000,-16000
30,3,2,1000.0,1,1,20000,15000,5000
25,8,2,1000.0,0,0,58000,66000,-8000
36,1,5,14600.0,0,1,40000,36000,4000
54,8,5,9000.0,1,1,962000,692000,270000
23,1,5,0.0,0,1,44000,55000,-11000
18,5,0,0.0,1,1,154000,174000,-20000
53,1,2,9000.0,1,0,90000,91000,-1000
35,4,3,8000.0,1,1,281000,295000,-14000
21,3,5,7000.0,0,0,169000,238000,-69000
22,5,2,1000.0,1,0,48000,39000,9000
33,3,3,312700.0,1,1,763000,504000,259000
45,3,2,2000.0,1,1,48000,43000,5000
55,8,3,24000.0,1,1,289000,234000,55000
50,3,2,8000.0,0,1,193000,300000,-107000
21,4,3,2000.0,0,0,60000,137000,-77000
21,4,0,48000.0,0,1,20000,23000,-3000
42,4,5,8000.0,1,1,301000,266000,35000
55,1,2,6000.0,0,0,48000,42000,6000
32,4,5,4000.0,1,1,90000,120000,-30000
23,5,5,0.0,0,1,57000,59000,-2000
26,5,5,8000.0,1,1,385000,360000,25000
32,5,5,2000.0,0,1,60000,87000,-27000
23,5,3,73000.0,1,1,434000,369000,65000
47,8,0,0.0,0,1,301000,295000,6000
35,4,2,55000.0,1,1,144000,171000,-27000
50,5,0,0.0,1,1,89000,99000,-10000
35,4,3,1640000.0,1,0,2410000,1069000,1341000
52,3,5,9000.0,1,0,362000,352000,10000
22,5,0,0.0,1,1,321000,307000,14000
27,4,3,7000.0,0,1,241000,189000,52000
42,4,3,330000.0,1,1,1205000,824000,381000
42,3,3,9000.0,1,1,289000,215000,74000
26,4,0,0.0,1,1,72000,91000,-19000
38,8,2,1000.0,1,1,20000,19000,1000
34,5,5,0.0,0,0,151000,136000,15000
23,1,2,10000.0,0,0,151000,169000,-18000
42,4,3,1500000.0,1,1,2410000,1462000,948000
50,3,5,9000.0,1,1,362000,375000,-13000
50,5,4,0.0,2,1,151000,125000,26000
42,5,1,0.0,1,1,295000,263000,32000
45,3,3,10500.0,1,1,144000,153000,-9000
54,5,5,10000.0,0,1,733000,471000,262000
22,4,2,1000.0,1,1,30000,28000,2000
30,5,3,7000.0,1,1,301000,366000,-65000
50,1,4,0.0,0,1,189000,137000,52000
25,5,3,194000.0,1,1,763000,381000,382000
31,5,3,59000.0,1,0,482000,330000,152000
46,3,2,9000.0,1,1,285000,231000,54000
49,3,2,2000.0,1,1,48000,40000,8000
30,4,3,7000.0,1,1,241000,199000,42000
26,3,4,0.0,1,1,121000,72000,49000
21,3,3,41000.0,1,1,385000,300000,85000
32,5,0,0.0,0,1,151000,126000,25000
40,4,3,69000.0,1,1,402000,319000,83000
40,3,4,0.0,0,1,151000,120000,31000
30,3,2,3000.0,0,1,51000,79000,-28000
33,4,4,0.0,0,1,160000,108000,52000
24,3,4,69000.0,0,1,402000,275000,127000
35,5,3,5000.0,1,1,151000,135000,16000
26,8,0,0.0,1,0,201000,190000,11000
31,1,2,32500.0,0,1,100000,146000,-46000
45,3,0,0.0,1,1,201000,214000,-13000
25,3,2,2000.0,1,1,48000,42000,6000
28,3,0,0.0,1,1,60000,75000,-15000
57,3,3,8000.0,1,1,201000,427000,-226000
48,8,3,14000.0,1,1,251000,220000,31000
42,5,3,97000.0,1,1,595000,440000,155000
27,5,3,4000.0,0,1,121000,108000,13000
38,3,3,5000.0,2,1,96000,93000,3000
30,4,5,10000.0,0,1,602000,385000,217000
20,3,2,6000.0,1,1,144000,226000,-82000
26,4,5,18500.0,0,1,70000,70000,0
42,5,3,89000.0,2,1,602000,307000,295000
27,3,5,5000.0,0,1,96000,131000,-35000
27,1,5,10000.0,0,0,151000,155000,-4000
55,1,2,9000.0,0,0,100000,159000,-59000
38,3,3,77000.0,2,1,502000,306000,196000
26,4,5,7000.0,0,1,221000,249000,-28000
75,3,2,5000.0,2,0,100000,150000,-50000
36,3,2,5000.0,2,1,100000,113000,-13000
65,3,0,0.0,2,1,100000,84000,16000
35,3,2,5000.0,2,1,100000,161000,-61000
27,1,3,10000.0,1,1,289000,239000,50000
38,1,2,9000.0,2,0,100000,113000,-13000
29,3,3,9000.0,1,0,281000,240000,41000
40,5,2,107000.0,1,1,291000,250000,41000
24,8,2,1000.0,1,1,30000,25000,5000
36,5,5,50000.0,1,1,362000,428000,-66000
31,5,5,11550.0,0,1,110000,153000,-43000
32,5,5,7000.0,1,1,301000,259000,42000
30,5,5,0.0,0,1,151000,158000,-7000
50,1,2,9000.0,0,1,100000,129000,-29000
33,4,2,2000.0,1,1,58000,53000,5000
62,1,2,8000.0,0,1,80000,89000,-9000
52,3,2,9000.0,1,1,281000,251000,30000
40,1,2,9000.0,0,1,90000,123000,-33000
37,1,2,9000.0,0,1,100000,120000,-20000
34,8,4,170000.0,1,1,620000,319000,301000
27,5,1,0.0,1,1,153000,145000,8000
35,5,3,7000.0,0,0,301000,256000,45000
48,8,1,0.0,0,1,372000,328000,44000
27,1,2,9000.0,0,0,100000,129000,-29000
32,1,2,9000.0,0,1,100000,122000,-22000
45,1,2,9000.0,2,1,100000,145000,-45000
40,1,2,9000.0,0,1,100000,158000,-58000
36,1,2,13500.0,2,1,100000,126000,-26000
32,1,2,9000.0,2,1,100000,158000,-58000
29,5,3,7000.0,0,0,301000,226000,75000
25,3,2,5000.0,2,1,100000,108000,-8000
28,1,0,0.0,2,1,60000,53000,7000
33,1,2,8000.0,0,1,80000,78000,2000
25,8,2,10000.0,1,1,48000,47000,1000
18,5,5,0.0,0,1,151000,136000,15000
40,3,2,2000.0,0,1,48000,46000,2000
18,4,3,2000.0,1,1,48000,29000,19000
55,5,2,5500.0,0,1,20000,15000,5000
27,1,2,221000.0,0,1,90000,103000,-13000
32,5,5,0.0,0,0,44000,56000,-12000
65,9,2,1000.0,1,1,20000,14000,6000
40,5,5,0.0,0,1,151000,149000,2000
30,5,5,0.0,0,1,57000,51000,6000
45,5,5,5000.0,0,1,151000,177000,-26000
23,5,3,95000.0,1,1,573000,488000,85000
22,5,2,285000.0,0,1,160000,255000,-95000
35,3,3,36000.0,0,1,207000,158000,49000
30,3,4,0.0,0,1,51000,43000,8000
50,3,4,0.0,0,1,51000,38000,13000
18,3,3,1000.0,0,1,24000,102000,-78000
70,5,0,0.0,1,1,151000,134000,17000
30,5,0,0.0,0,1,60000,61000,-1000
25,5,5,0.0,0,1,57000,66000,-9000
41,5,4,0.0,0,1,90000,151000,-61000
40,3,4,0.0,0,1,44000,41000,3000
32,8,3,168000.0,1,1,605000,293000,312000
45,3,4,0.0,0,1,57000,91000,-34000
35,3,4,0.0,0,1,60000,45000,15000
30,3,4,193000.0,1,1,829000,657000,172000
18,3,4,0.0,0,1,60000,46000,14000
60,5,4,203000.0,0,1,751000,383000,368000
44,5,5,4500.0,0,1,51000,67000,-16000
30,5,2,6000.0,0,1,201000,150000,51000
23,5,0,4500.0,1,1,44000,39000,5000
35,5,5,5000.0,0,1,151000,160000,-9000
34,5,2,11000.0,1,1,30000,23000,7000
28,5,5,0.0,0,1,44000,58000,-14000
26,3,2,2000.0,1,1,48000,39000,9000
35,4,5,0.0,0,1,36000,30000,6000
38,5,3,5000.0,0,1,151000,145000,6000
32,3,3,9000.0,0,1,301000,229000,72000
34,1,2,27000.0,0,1,100000,104000,-4000
45,4,3,7000.0,0,1,241000,321000,-80000
38,3,2,9000.0,0,1,301000,227000,74000
32,1,2,8000.0,2,1,72000,72000,0
38,1,2,8000.0,2,1,72000,83000,-11000
55,1,4,0.0,0,1,44000,40000,4000
45,1,3,7000.0,2,1,60000,149000,-89000
40,3,2,3000.0,0,0,58000,46000,12000
38,1,3,7000.0,0,1,57000,56000,1000
27,3,2,9000.0,1,0,381000,318000,63000
33,1,5,0.0,0,1,100000,85000,15000
24,1,3,6000.0,2,1,46000,63000,-17000
18,3,5,15600.0,0,1,51000,62000,-11000
29,4,5,0.0,0,1,40000,38000,2000
35,1,5,90000.0,0,1,40000,55000,-15000
60,5,3,312000.0,1,1,723000,319000,404000
35,5,1,0.0,1,0,86000,77000,9000
28,5,3,88000.0,0,1,592000,325000,267000
40,3,3,8000.0,1,1,241000,175000,66000
60,4,5,29000.0,1,0,992000,726000,266000
38,1,2,8000.0,0,1,72000,69000,3000
52,1,2,8000.0,0,1,72000,80000,-8000
49,5,2,3000.0,1,1,99000,113000,-14000
25,5,2,1000.0,0,1,48000,38000,10000
26,4,3,1515000.0,1,0,2410000,1389000,1021000
55,3,2,2000.0,0,1,48000,59000,-11000
28,4,2,3000.0,1,1,68000,57000,11000
73,3,5,10000.0,0,1,462000,363000,99000
46,4,2,6000.0,1,0,151000,176000,-25000
70,4,3,70000.0,1,0,490000,348000,142000
47,8,1,0.0,1,1,531000,378000,153000
19,3,3,8000.0,1,1,221000,201000,20000
35,5,1,0.0,1,1,237000,242000,-5000
23,1,2,8000.0,2,1,72000,87000,-15000
36,8,2,2000.0,1,1,104000,162000,-58000
30,2,1,0.0,1,1,36000,36000,0
60,4,1,0.0,0,1,180000,165000,15000
70,4,5,8000.0,0,1,301000,223000,78000
18,2,0,0.0,0,1,36000,34000,2000
19,2,0,0.0,1,1,39000,42000,-3000
22,5,4,0.0,1,1,217000,229000,-12000
40,4,3,5000.0,1,1,145000,214000,-69000
30,6,0,0.0,1,1,180000,164000,16000
36,5,1,0.0,1,0,53000,45000,8000
51,4,4,0.0,1,1,217000,332000,-115000
28,5,5,7000.0,1,1,301000,359000,-58000
30,5,5,109000.0,1,0,542000,412000,130000
31,4,1,0.0,0,1,145000,143000,2000
39,1,0,0.0,1,1,29000,31000,-2000
26,1,3,39000.0,1,0,217000,164000,53000
43,5,0,0.0,1,1,48000,62000,-14000
76,4,0,0.0,0,0,145000,126000,19000
45,6,1,0.0,0,1,180000,161000,19000
30,6,1,0.0,0,1,217000,216000,1000
18,6,5,8000.0,1,1,421000,374000,47000
35,6,0,0.0,0,1,145000,143000,2000
25,2,1,0.0,1,1,34000,37000,-3000
45,2,1,0.0,0,1,29000,35000,-6000
28,5,5,5000.0,1,1,180000,202000,-22000
40,6,0,0.0,0,1,193000,167000,26000
52,5,5,7000.0,1,1,265000,257000,8000
37,4,0,0.0,1,1,145000,134000,11000
40,5,0,0.0,1,1,145000,142000,3000
33,4,3,58000.0,1,1,277000,328000,-51000
46,4,5,8000.0,1,1,253000,248000,5000
30,5,1,0.0,1,1,53000,44000,9000
65,5,1,0.0,1,1,169000,150000,19000
22,6,0,0.0,1,1,193000,189000,4000
35,6,0,0.0,1,1,157000,142000,15000
30,4,0,0.0,1,1,145000,152000,-7000
40,4,3,109000.0,1,1,421000,352000,69000
33,5,5,143000.0,1,1,421000,297000,124000
31,4,4,0.0,2,1,180000,139000,41000
32,5,3,189000.0,2,1,482000,358000,124000
32,5,1,0.0,1,0,48000,44000,4000
30,2,4,0.0,1,0,145000,208000,-63000
57,2,4,0.0,1,1,241000,228000,13000
30,2,3,80000.0,0,1,361000,422000,-61000
26,5,4,0.0,1,0,180000,230000,-50000
62,4,4,0.0,1,1,121000,184000,-63000
35,4,4,0.0,0,0,241000,262000,-21000
38,4,5,8000.0,1,1,265000,324000,-59000
34,5,1,30000.0,0,0,84000,97000,-13000
25,8,0,2500.0,1,1,133000,123000,10000
35,4,3,53000.0,1,1,127000,277000,-150000
33,8,4,48500.0,0,0,102000,84000,18000
44,5,4,55000.0,1,1,217000,283000,-66000
33,6,4,27500.0,1,0,286000,278000,8000
44,2,4,18000.0,1,1,80000,61000,19000
36,4,5,125000.0,1,1,218000,167000,51000
43,6,4,37000.0,0,1,271000,223000,48000
58,5,4,103000.0,1,1,320000,326000,-6000
31,5,4,72500.0,0,1,159000,259000,-100000
25,1,0,3000.0,1,1,19000,23000,-4000
20,8,4,7000.0,0,1,90000,67000,23000
50,6,4,29000.0,1,1,190000,157000,33000
29,4,3,90000.0,1,1,295000,160000,135000
49,8,3,49000.0,1,1,145000,151000,-6000
44,5,5,15000.0,1,1,112000,195000,-83000
52,5,4,50000.0,0,1,201000,146000,55000
19,6,5,95000.0,1,1,320000,322000,-2000
25,5,4,30000.0,1,1,117000,80000,37000
28,5,4,19000.0,1,1,159000,118000,41000
55,5,4,60000.0,1,1,94000,76000,18000
23,2,3,47000.0,1,0,133000,280000,-147000
28,5,4,54000.0,0,0,115000,79000,36000
21,4,3,72000.0,1,0,145000,309000,-164000
30,6,4,125000.0,1,0,343000,432000,-89000
28,5,3,53500.0,0,1,136000,265000,-129000
33,4,4,39000.0,0,1,96000,157000,-61000
28,5,4,30000.0,1,0,30000,29000,1000
40,5,4,80000.0,1,1,151000,129000,22000
35,5,5,42600.0,1,1,180000,190000,-10000
19,4,3,687600.0,1,0,549000,346000,203000
34,6,0,2500.0,1,1,163000,142000,21000
30,4,3,329000.0,1,0,253000,248000,5000
47,9,5,519000.0,1,1,374000,315000,59000
35,2,2,8000.0,1,1,130000,142000,-12000
30,4,3,439000.0,1,1,203000,234000,-31000
60,2,2,6000.0,1,1,84000,131000,-47000
45,8,1,7820.0,1,1,318000,232000,86000
34,4,0,151800.0,1,0,142000,134000,8000
65,2,2,51000.0,1,1,77000,119000,-42000
75,5,5,30000.0,1,1,199000,190000,9000
40,9,3,439000.0,1,1,421000,273000,148000
32,4,3,162000.0,1,1,149000,154000,-5000
36,8,5,119000.0,1,1,253000,255000,-2000
21,5,3,195900.0,1,0,320000,194000,126000
50,5,3,155000.0,1,1,333000,202000,131000
25,6,3,277000.0,1,1,180000,172000,8000
40,5,0,3300.0,1,1,145000,136000,9000
58,6,5,216000.0,1,1,289000,266000,23000
35,5,5,596300.0,1,1,566000,344000,222000
23,5,3,368000.0,1,1,301000,256000,45000
30,6,5,61700.0,1,1,180000,191000,-11000
50,5,3,337700.0,1,1,361000,267000,94000
40,2,2,6000.0,1,1,84000,132000,-48000
36,5,5,330000.0,1,1,265000,231000,34000
45,2,0,3930.0,1,1,26000,25000,1000
32,5,3,739000.0,1,1,337000,281000,56000
21,9,3,325000.0,1,1,323000,276000,47000
30,5,5,54300.0,1,1,183000,224000,-41000
30,6,5,148000.0,1,1,241000,255000,-14000
42,4,3,285000.0,1,1,303000,197000,106000
26,2,3,433000.0,1,1,343000,289000,54000
40,2,3,220000.0,1,1,215000,174000,41000
30,2,2,6000.0,1,0,84000,130000,-46000
50,2,3,328300.0,1,1,246000,224000,22000
49,2,1,13430.0,1,1,56000,72000,-16000
35,5,3,222000.0,1,1,253000,183000,70000
25,5,5,208000.0,1,1,289000,269000,20000
25,5,3,295000.0,1,1,178000,218000,-40000
62,2,5,13000.0,1,1,92000,110000,-18000
27,6,5,63000.0,1,1,186000,203000,-17000
27,5,5,92000.0,1,1,391000,399000,-8000
23,5,5,87000.0,1,1,400000,462000,-62000
32,4,5,105000.0,1,1,416000,321000,95000
55,9,4,6500.0,1,1,12000,21000,-9000
42,4,4,78000.0,1,1,307000,362000,-55000
20,4,4,37000.0,0,1,283000,248000,35000
38,8,4,81000.0,1,1,343000,388000,-45000
18,2,0,4400.0,0,1,33000,33000,0
22,5,3,55000.0,1,1,159000,163000,-4000
55,4,3,196000.0,1,1,904000,528000,376000
29,6,3,457000.0,1,1,391000,287000,104000
36,4,5,169000.0,1,1,398000,453000,-55000
85,6,3,127000.0,1,1,295000,217000,78000
35,5,4,0.0,2,1,301000,356000,-55000
50,6,3,112000.0,1,1,391000,517000,-126000
36,4,0,4140.0,1,0,51000,50000,1000
21,4,5,208000.0,1,1,169000,223000,-54000
36,4,4,146000.0,1,1,193000,169000,24000
45,5,5,288400.0,1,1,235000,244000,-9000
25,5,1,6200.0,1,1,172000,139000,33000
20,4,5,294000.0,1,1,210000,210000,0
30,2,2,187100.0,1,1,210000,168000,42000
45,5,3,740000.0,1,1,320000,272000,48000
26,4,5,297000.0,1,0,277000,243000,34000
35,6,5,158000.0,1,1,159000,166000,-7000
45,5,5,192800.0,1,1,180000,183000,-3000
27,5,3,1129000.0,1,1,499000,418000,81000
29,4,5,370000.0,1,1,217000,219000,-2000
21,6,1,5680.0,1,1,72000,76000,-4000
31,6,3,152500.0,1,0,426000,252000,174000
28,2,3,176000.0,1,1,130000,150000,-20000
40,4,5,774000.0,1,1,477000,321000,156000
45,5,5,5000.0,1,0,180000,231000,-51000
29,2,3,167000.0,1,1,137000,147000,-10000
40,4,5,233000.0,1,1,289000,256000,33000
35,4,3,203000.0,1,1,318000,188000,130000
18,2,5,126000.0,1,1,200000,206000,-6000
35,4,5,108000.0,1,1,205000,200000,5000
45,4,5,113000.0,1,1,566000,487000,79000
30,4,5,215000.0,1,1,169000,195000,-26000
30,4,5,350500.0,1,1,376000,301000,75000
75,2,2,5000.0,1,1,72000,83000,-11000
28,4,5,1197000.0,1,0,651000,411000,240000
18,6,5,205300.0,1,0,199000,188000,11000
25,6,5,88900.0,1,1,231000,217000,14000
29,2,2,6000.0,1,1,87000,124000,-37000
68,2,5,87000.0,1,1,186000,181000,5000
26,5,5,9000.0,2,1,186000,227000,-41000
31,4,1,4000.0,2,1,96000,101000,-5000
62,6,3,60000.0,2,1,289000,227000,62000
60,5,3,243000.0,2,1,289000,239000,50000
42,6,5,107000.0,2,0,127000,156000,-29000
38,4,3,36500.0,2,1,169000,121000,48000
34,2,5,155000.0,2,1,180000,189000,-9000
35,5,3,208900.0,1,1,224000,178000,46000
35,2,5,37000.0,1,0,145000,167000,-22000
30,4,3,393000.0,1,0,180000,184000,-4000
48,2,2,7000.0,1,1,123000,152000,-29000
30,2,5,97700.0,1,1,113000,137000,-24000
30,5,5,760000.0,1,0,434000,283000,151000
55,4,3,245000.0,2,1,260000,197000,63000
29,5,3,202000.0,2,1,174000,174000,0
67,5,1,9500.0,2,1,145000,136000,9000
40,2,3,20000.0,1,1,174000,176000,-2000
22,4,5,32000.0,2,0,145000,142000,3000
35,4,5,530000.0,2,1,301000,277000,24000
35,4,3,19000.0,2,1,174000,155000,19000
35,5,3,300000.0,2,1,320000,259000,61000
60,5,5,420000.0,2,1,241000,200000,41000
22,5,3,116000.0,2,1,301000,251000,50000
41,5,3,51000.0,2,1,307000,193000,114000
32,4,3,61000.0,2,1,217000,149000,68000
45,5,3,14000.0,2,0,217000,268000,-51000
30,5,5,27500.0,2,1,145000,207000,-62000
26,5,5,2000.0,2,1,133000,193000,-60000
32,6,1,6600.0,0,1,288000,252000,36000
37,4,5,2000.0,1,1,241000,215000,26000
48,5,5,5300.0,0,0,244000,249000,-5000
45,2,4,38500.0,0,1,229000,167000,62000
24,4,3,180000.0,0,1,542000,373000,169000
45,5,3,60000.0,0,1,261000,228000,33000
32,5,2,132000.0,0,1,301000,238000,63000
54,1,4,7000.0,0,1,169000,99000,70000
24,5,3,225000.0,0,1,410000,315000,95000
32,4,3,160000.0,1,1,563000,503000,60000
21,5,3,81500.0,1,1,542000,456000,86000
46,4,5,28000.0,0,1,301000,231000,70000
50,5,3,35700.0,1,0,304000,248000,56000
32,5,4,65900.0,1,1,403000,239000,164000
23,6,4,7000.0,0,1,209000,178000,31000
37,4,1,6100.0,0,1,62000,73000,-11000
33,2,4,1500.0,0,1,256000,149000,107000
34,2,4,37000.0,1,1,193000,140000,53000
29,5,4,49000.0,1,1,304000,201000,103000
28,6,3,1957000.0,1,1,2309000,924000,1385000
30,5,5,10000.0,1,1,253000,216000,37000
25,5,4,17000.0,0,1,227000,207000,20000
37,4,4,82500.0,0,1,505000,275000,230000
28,5,5,1500.0,0,1,244000,208000,36000
21,2,4,7000.0,0,1,160000,97000,63000
18,2,4,17000.0,0,1,180000,123000,57000
33,9,4,116500.0,0,1,526000,311000,215000
56,5,4,8500.0,0,1,245000,145000,100000
50,5,4,244000.0,1,1,1205000,673000,532000
20,5,4,26300.0,1,1,151000,153000,-2000
31,10,1,10000.0,0,1,265000,213000,52000
68,4,4,7300.0,0,1,205000,144000,61000
48,9,3,31500.0,1,1,292000,341000,-49000
26,4,4,4000.0,0,1,205000,121000,84000
28,6,5,57500.0,0,1,365000,357000,8000
62,10,1,0.0,0,1,289000,270000,19000
49,4,4,13200.0,0,1,225000,151000,74000
19,2,4,10500.0,0,1,193000,133000,60000
23,5,3,25000.0,1,1,244000,262000,-18000
36,6,3,271500.0,1,1,691000,346000,345000
25,8,4,51000.0,1,1,304000,226000,78000
30,5,1,22000.0,0,1,224000,211000,13000
62,6,4,12700.0,0,1,209000,175000,34000
18,1,5,10000.0,1,1,169000,176000,-7000
36,2,4,1500.0,0,0,208000,147000,61000
31,2,3,5500.0,0,0,134000,112000,22000
50,4,2,8000.0,0,1,172000,214000,-42000
46,8,3,52500.0,1,1,301000,293000,8000
29,2,1,76000.0,0,1,60000,60000,0
45,4,4,170000.0,1,1,301000,200000,101000
34,5,4,91000.0,0,1,318000,220000,98000
40,5,1,83200.0,0,0,68000,78000,-10000
58,2,1,90900.0,0,1,62000,64000,-2000
29,4,4,160000.0,1,1,414000,309000,105000
25,4,3,170000.0,1,1,522000,281000,241000
30,2,0,13000.0,0,1,57000,49000,8000
25,12,5,250000.0,0,1,442000,322000,120000
50,5,1,36000.0,0,1,205000,234000,-29000
24,6,4,335000.0,0,1,397000,235000,162000
62,8,1,9650.0,0,1,416000,260000,156000
30,5,0,14000.0,0,1,271000,274000,-3000
60,4,3,295000.0,0,0,403000,277000,126000
31,5,1,12000.0,0,1,74000,99000,-25000
35,4,3,180000.0,0,0,303000,251000,52000
28,5,3,230000.0,0,1,364000,271000,93000
28,4,4,160000.0,0,1,255000,154000,101000
18,9,3,245000.0,0,1,404000,298000,106000
19,4,3,130000.0,0,1,404000,254000,150000
18,2,4,110000.0,0,1,202000,121000,81000
32,1,0,35000.0,0,1,30000,34000,-4000
29,5,1,73000.0,0,0,286000,231000,55000
38,4,4,60000.0,0,1,244000,167000,77000
35,2,3,20000.0,0,1,142000,133000,9000
30,5,3,55000.0,0,1,241000,229000,12000
28,2,3,108000.0,0,0,339000,246000,93000
20,6,5,300000.0,0,0,537000,356000,181000
30,2,4,135000.0,0,1,214000,128000,86000
60,2,3,285000.0,0,1,416000,316000,100000
26,4,4,160000.0,0,0,256000,174000,82000
33,4,1,5000.0,0,1,76000,82000,-6000
26,2,4,115000.0,0,1,211000,125000,86000
28,5,1,10000.0,0,1,180000,173000,7000
45,5,3,318000.0,0,0,404000,342000,62000
30,2,4,92000.0,0,1,173000,110000,63000
23,6,4,120000.0,0,1,211000,157000,54000
32,2,1,96100.0,0,1,60000,59000,1000
31,2,4,97000.0,0,1,191000,126000,65000
37,4,5,89000.0,0,1,274000,236000,38000
28,4,4,259000.0,0,1,315000,185000,130000
43,5,4,150000.0,0,0,263000,167000,96000
35,5,1,62850.0,0,1,269000,225000,44000
38,3,4,0.0,0,1,73000,51000,22000
31,3,2,10000.0,1,0,451000,307000,144000
25,3,2,9000.0,1,1,271000,195000,76000
35,3,4,0.0,1,0,296000,187000,109000
25,3,4,0.0,1,0,109000,62000,47000
40,3,2,3000.0,1,1,60000,67000,-7000
36,3,4,0.0,0,1,151000,120000,31000
45,3,4,0.0,1,1,121000,79000,42000
56,3,4,0.0,0,1,241000,145000,96000
60,3,2,7000.0,0,1,180000,189000,-9000
30,3,0,0.0,1,0,73000,79000,-6000
23,5,1,0.0,1,1,155000,178000,-23000
67,3,4,0.0,1,1,75000,50000,25000
56,9,2,1000.0,0,1,60000,54000,6000
48,2,0,0.0,0,1,127000,119000,8000
20,5,0,0.0,1,1,91000,91000,0
25,6,0,0.0,0,1,105000,97000,8000
38,2,4,0.0,0,1,73000,42000,31000
25,3,4,0.0,0,1,87000,57000,30000
46,2,4,0.0,0,0,73000,43000,30000
30,3,2,7000.0,0,1,151000,164000,-13000
20,2,2,9000.0,0,1,210000,197000,13000
50,3,2,8000.0,0,0,210000,164000,46000
30,3,2,7000.0,0,1,157000,139000,18000
25,3,2,38000.0,0,1,210000,180000,30000
30,2,4,0.0,0,1,87000,67000,20000
59,2,4,0.0,0,1,73000,50000,23000
45,2,4,0.0,0,1,180000,92000,88000
26,3,2,7000.0,0,1,151000,151000,0
19,3,4,0.0,1,1,73000,42000,31000
51,3,4,0.0,1,1,301000,197000,104000
29,9,2,5000.0,0,1,301000,275000,26000
28,2,2,10000.0,1,1,301000,268000,33000
19,2,3,50000.0,0,1,301000,219000,82000
30,2,4,0.0,1,0,301000,197000,104000
47,3,4,0.0,0,1,301000,225000,76000
36,3,4,0.0,0,1,301000,225000,76000
27,3,4,0.0,1,1,301000,227000,74000
20,2,4,0.0,1,1,301000,225000,76000
20,3,4,0.0,1,1,301000,225000,76000
19,3,4,0.0,0,1,151000,121000,30000
36,2,4,0.0,0,1,151000,122000,29000
19,3,4,0.0,0,1,180000,107000,73000
28,5,4,68000.0,0,1,392000,291000,101000
45,9,4,0.0,0,1,121000,96000,25000
50,3,4,0.0,2,1,73000,45000,28000
19,2,2,57000.0,1,1,362000,295000,67000
32,2,4,0.0,0,1,180000,122000,58000
30,2,4,0.0,1,1,301000,225000,76000
48,2,2,10000.0,1,1,301000,311000,-10000
24,2,4,0.0,0,1,301000,225000,76000
32,2,2,10000.0,1,1,301000,271000,30000
25,2,2,10000.0,1,1,301000,275000,26000
26,2,2,10000.0,1,0,301000,275000,26000
30,2,2,10000.0,2,1,301000,228000,73000
18,2,2,10000.0,1,0,301000,1008000,-707000
45,2,2,10000.0,1,0,301000,268000,33000
35,5,0,0.0,0,1,241000,253000,-12000
50,5,4,203000.0,1,1,933000,501000,432000
70,5,4,0.0,0,1,121000,97000,24000
25,5,4,0.0,0,1,210000,183000,27000
50,6,4,0.0,1,1,121000,78000,43000
40,2,0,0.0,1,1,48000,43000,5000
42,2,2,8000.0,0,1,151000,129000,22000
25,3,4,0.0,0,1,151000,110000,41000
24,6,4,0.0,0,1,241000,198000,43000
34,3,4,758000.0,0,1,1867000,751000,1116000
39,5,4,66000.0,0,1,362000,296000,66000
42,5,4,0.0,0,1,301000,188000,113000
26,5,2,7000.0,0,1,301000,249000,52000
28,5,4,0.0,0,1,301000,180000,121000
30,5,4,0.0,0,1,301000,246000,55000
22,5,4,0.0,0,1,60000,49000,11000
39,5,4,0.0,0,1,301000,162000,139000
35,5,4,0.0,2,0,301000,191000,110000
18,5,4,0.0,2,0,301000,200000,101000
30,5,4,0.0,0,0,301000,246000,55000
30,5,4,50.0,2,1,301000,188000,113000
30,5,4,0.0,2,0,301000,179000,122000
47,5,4,0.0,0,1,301000,246000,55000
25,5,4,0.0,0,1,301000,246000,55000
52,5,2,2000.0,0,1,60000,53000,7000
35,5,4,0.0,0,1,301000,246000,55000
35,5,4,66000.0,0,1,362000,296000,66000
50,5,4,0.0,0,1,301000,246000,55000
36,5,4,0.0,1,1,301000,246000,55000
45,5,4,66000.0,0,1,362000,296000,66000
40,5,4,0.0,0,1,301000,246000,55000
24,5,4,0.0,1,1,132000,108000,24000
50,3,4,25000.0,1,1,109000,89000,20000
35,3,4,0.0,1,1,109000,89000,20000
25,3,4,0.0,1,1,121000,99000,22000
29,5,4,66000.0,1,1,362000,296000,66000
55,5,4,0.0,1,1,121000,99000,22000
25,3,2,9000.0,1,1,301000,249000,52000
22,3,3,0.0,1,1,301000,341000,-40000
35,5,0,0.0,0,1,301000,309000,-8000
32,3,3,0.0,1,1,301000,253000,48000
46,5,2,1000.0,1,0,32000,28000,4000
78,6,1,0.0,1,1,301000,172000,129000
52,3,3,0.0,1,1,301000,323000,-22000
30,3,3,0.0,1,1,301000,301000,0
49,3,3,50.0,1,1,301000,252000,49000
60,3,2,9000.0,1,1,301000,215000,86000
40,5,2,7050.0,1,1,301000,216000,85000
28,3,3,0.0,1,1,301000,295000,6000
22,2,4,0.0,0,1,301000,225000,76000
22,2,2,10000.0,0,1,301000,262000,39000
45,3,4,0.0,0,1,301000,177000,124000
18,2,2,10000.0,1,1,301000,586000,-285000
30,2,2,10000.0,1,1,301000,986000,-685000
30,2,2,10000.0,1,1,301000,580000,-279000
29,2,2,10000.0,1,0,301000,719000,-418000
43,3,3,0.0,1,1,301000,252000,49000
35,2,2,10000.0,1,0,301000,494000,-193000
22,2,3,0.0,1,1,301000,278000,23000
42,3,2,21500.0,0,0,301000,275000,26000
36,6,2,10000.0,1,1,1205000,1011000,194000
35,6,2,10000.0,1,1,1205000,862000,343000
25,5,2,9000.0,1,1,602000,428000,174000
53,5,2,10000.0,1,1,1205000,960000,245000
30,6,2,10000.0,1,1,1205000,922000,283000
30,5,2,23500.0,1,1,602000,465000,137000
24,3,4,200000.0,0,1,903000,589000,314000
45,5,4,0.0,0,1,91000,64000,27000
67,3,4,67000.0,2,1,362000,206000,156000
45,6,2,7000.0,0,1,362000,272000,90000
28,5,3,0.0,1,1,964000,882000,82000
31,6,4,200000.0,0,1,903000,489000,414000
35,6,4,234000.0,0,1,903000,556000,347000
25,9,2,58000.0,0,1,724000,551000,173000
52,6,4,88000.0,0,1,422000,504000,-82000
26,3,4,191000.0,0,1,422000,265000,157000
50,5,4,182000.0,0,1,724000,455000,269000
28,5,2,3500.0,0,1,91000,142000,-51000
26,3,4,0.0,2,0,241000,175000,66000
25,5,0,0.0,2,1,180000,142000,38000
32,9,4,193000.0,0,1,843000,552000,291000
40,5,4,136000.0,2,1,541000,288000,253000
32,5,0,0.0,2,1,362000,443000,-81000
30,9,4,190000.0,0,1,903000,611000,292000
33,9,3,0.0,2,0,903000,770000,133000
20,2,3,48500.0,2,0,362000,390000,-28000
55,3,0,0.0,2,1,144000,130000,14000
32,6,3,0.0,2,1,843000,673000,170000
21,3,4,218000.0,2,1,1085000,679000,406000
28,5,5,0.0,2,1,724000,543000,181000
36,5,5,486000.0,2,1,1326000,850000,476000
29,3,4,18000.0,1,0,121000,77000,44000
40,3,4,0.0,1,1,121000,102000,19000
25,5,1,47500.0,0,1,314000,229000,85000
23,5,4,15000.0,0,1,241000,212000,29000
70,3,4,0.0,1,0,121000,103000,18000
24,5,4,104500.0,2,1,151000,101000,50000
40,5,1,0.0,0,1,151000,124000,27000
50,5,5,8000.0,0,0,422000,252000,170000
25,2,0,0.0,0,0,30000,36000,-6000
38,11,1,0.0,1,0,151000,204000,-53000
35,5,0,0.0,1,1,121000,126000,-5000
50,6,4,0.0,1,1,121000,96000,25000
23,5,0,0.0,1,1,121000,127000,-6000
37,6,1,0.0,1,0,187000,210000,-23000
23,11,0,0.0,1,1,180000,191000,-11000
28,11,1,0.0,1,0,151000,163000,-12000
55,3,4,602000.0,0,1,1445000,1088000,357000
50,5,4,4000.0,1,1,91000,59000,32000
56,5,1,6000.0,1,1,91000,74000,17000
53,5,2,9600.0,1,1,481000,505000,-24000
35,5,0,500.0,2,1,422000,301000,121000
25,5,4,200000.0,2,1,903000,587000,316000
31,3,1,0.0,0,1,91000,82000,9000
46,3,5,10000.0,1,1,693000,574000,119000
25,3,5,5000.0,1,1,91000,93000,-2000
46,3,5,490000.0,1,1,1356000,1247000,109000
20,3,5,5000.0,1,1,91000,83000,8000
20,2,5,10000.0,1,1,463000,473000,-10000
26,3,5,10000.0,1,1,1144000,1014000,130000
30,3,5,19000.0,0,1,608000,602000,6000
30,3,5,5000.0,0,1,91000,82000,9000
30,3,5,100000.0,0,1,862000,518000,344000
35,2,5,10000.0,1,1,976000,766000,210000
32,3,0,0.0,1,1,91000,87000,4000
30,3,2,9000.0,0,1,271000,309000,-38000
60,3,4,5000.0,1,1,121000,179000,-58000
30,3,3,0.0,1,1,362000,304000,58000
25,3,4,0.0,1,1,121000,81000,40000
85,3,3,0.0,1,1,362000,314000,48000
25,3,5,0.0,1,1,362000,278000,84000
60,3,4,0.0,0,1,121000,84000,37000
45,3,0,0.0,0,1,91000,91000,0
18,3,0,0.0,1,1,121000,114000,7000
55,3,5,0.0,1,1,362000,275000,87000
25,3,0,0.0,1,1,241000,209000,32000
25,3,0,0.0,1,1,60000,64000,-4000
20,3,0,0.0,1,0,241000,193000,48000
25,3,3,0.0,1,1,362000,364000,-2000
35,3,4,0.0,1,1,241000,349000,-108000
34,3,4,0.0,1,1,121000,199000,-78000
55,3,5,0.0,0,1,301000,262000,39000
29,3,0,0.0,1,1,121000,120000,1000
45,3,0,0.0,1,1,121000,120000,1000
21,3,4,0.0,1,1,241000,200000,41000
24,3,3,0.0,1,1,362000,352000,10000
53,3,4,11000.0,0,1,13000,17000,-4000
38,3,5,0.0,1,1,362000,310000,52000
37,3,2,6000.0,1,0,121000,136000,-15000
40,3,4,0.0,1,1,241000,194000,47000
60,5,0,0.0,1,1,332000,363000,-31000
32,3,0,0.0,0,1,121000,112000,9000
59,3,0,0.0,1,0,121000,106000,15000
30,2,4,0.0,2,1,121000,76000,45000
50,5,0,0.0,0,1,121000,112000,9000
52,3,0,0.0,1,1,60000,62000,-2000
34,3,4,0.0,2,1,121000,92000,29000
22,3,0,0.0,1,1,241000,247000,-6000
34,3,0,0.0,1,0,121000,113000,8000
38,3,1,0.0,1,1,121000,154000,-33000
54,5,4,45000.0,0,1,121000,100000,21000
34,3,4,0.0,0,1,121000,202000,-81000
40,3,1,0.0,1,1,241000,215000,26000
36,3,2,1000.0,1,0,30000,39000,-9000
24,3,0,0.0,0,1,121000,107000,14000
42,3,0,52000.0,0,1,121000,116000,5000
42,3,0,0.0,0,1,121000,116000,5000
25,3,0,0.0,0,1,121000,102000,19000
70,3,0,0.0,0,0,121000,123000,-2000
28,3,0,0.0,0,1,121000,109000,12000
60,3,0,0.0,0,1,121000,108000,13000
25,2,0,0.0,0,1,121000,113000,8000
34,3,0,0.0,0,1,121000,119000,2000
18,3,0,0.0,0,1,121000,119000,2000
35,3,4,0.0,1,1,301000,166000,135000
61,3,4,0.0,1,1,301000,169000,132000
32,3,4,0.0,1,0,121000,78000,43000
50,3,4,0.0,1,1,301000,155000,146000
26,3,4,0.0,1,1,301000,189000,112000
65,3,4,0.0,1,1,301000,155000,146000
35,3,4,0.0,1,1,121000,84000,37000
49,5,2,7000.0,1,0,301000,250000,51000
38,3,4,0.0,1,1,301000,173000,128000
27,3,2,9000.0,0,1,301000,240000,61000
39,3,4,0.0,1,1,301000,194000,107000
40,3,4,0.0,1,1,301000,169000,132000
35,3,4,0.0,1,1,301000,160000,141000
58,5,0,0.0,0,1,121000,121000,0
29,3,4,0.0,1,1,301000,166000,135000
55,3,4,0.0,1,1,301000,179000,122000
32,3,4,0.0,1,0,121000,85000,36000
56,3,4,0.0,1,1,121000,140000,-19000
60,3,4,0.0,0,1,121000,112000,9000
48,3,4,25000.0,1,0,301000,176000,125000
70,3,4,0.0,0,0,121000,96000,25000
39,5,4,0.0,0,1,121000,155000,-34000
35,5,4,0.0,0,1,241000,254000,-13000
23,3,0,89500.0,0,1,241000,262000,-21000
30,3,3,6000.0,0,1,121000,342000,-221000
36,3,4,0.0,0,1,241000,179000,62000
26,6,4,0.0,0,1,253000,177000,76000
41,3,4,0.0,2,1,121000,103000,18000
30,3,4,0.0,2,0,121000,209000,-88000
34,3,2,6000.0,0,1,121000,155000,-34000
35,5,2,4000.0,1,0,121000,183000,-62000
30,3,4,45000.0,0,0,121000,101000,20000
25,3,4,0.0,1,1,121000,108000,13000
55,3,4,0.0,0,1,121000,83000,38000
27,3,2,6000.0,2,1,121000,145000,-24000
31,3,4,0.0,1,1,121000,84000,37000
22,3,2,6000.0,0,0,121000,116000,5000
40,3,4,0.0,0,1,121000,98000,23000
31,3,4,0.0,1,1,121000,94000,27000
30,3,4,0.0,1,1,121000,88000,33000
32,3,4,0.0,0,1,121000,95000,26000
38,3,0,0.0,0,1,121000,103000,18000
37,5,4,0.0,1,0,301000,175000,126000
69,3,4,0.0,2,0,121000,106000,15000
35,3,4,0.0,1,1,301000,215000,86000
34,3,4,0.0,1,0,121000,104000,17000
38,3,4,0.0,1,1,121000,83000,38000
18,3,4,0.0,0,0,121000,91000,30000
33,3,4,0.0,1,0,121000,100000,21000
34,3,4,0.0,2,1,121000,97000,24000
32,3,4,0.0,1,1,301000,194000,107000
28,3,0,0.0,0,1,121000,121000,0
28,5,4,0.0,1,0,301000,187000,114000
24,3,4,0.0,2,1,121000,91000,30000
75,3,2,3000.0,2,1,60000,45000,15000
20,3,2,3000.0,2,1,60000,57000,3000
40,3,2,6000.0,2,1,121000,189000,-68000
18,3,2,3000.0,2,0,60000,54000,6000
44,3,4,0.0,2,0,121000,104000,17000
35,3,2,6000.0,0,1,121000,106000,15000
35,3,2,11000.0,0,0,13000,11000,2000
18,3,4,0.0,1,1,121000,86000,35000
35,3,4,0.0,0,1,121000,84000,37000
29,3,4,0.0,1,1,121000,88000,33000
37,3,0,0.0,1,0,241000,196000,45000
36,3,0,0.0,1,0,271000,227000,44000
48,2,2,9000.0,1,1,180000,198000,-18000
37,3,2,9000.0,1,1,271000,236000,35000
35,3,2,9000.0,1,1,271000,204000,67000
49,3,1,0.0,1,0,91000,95000,-4000
29,5,5,0.0,1,1,541000,387000,154000
42,2,0,0.0,1,1,151000,155000,-4000
25,3,3,5000.0,1,0,91000,131000,-40000
26,3,0,0.0,1,0,60000,61000,-1000
19,2,0,0.0,1,1,60000,54000,6000
18,2,0,0.0,1,0,60000,55000,5000
37,3,1,5000.0,1,1,84000,103000,-19000
40,5,0,0.0,1,1,121000,107000,14000
30,5,1,0.0,1,0,210000,189000,21000
30,5,0,7000.0,1,1,306000,378000,-72000
32,2,1,15000.0,1,0,114000,108000,6000
49,5,1,0.0,1,0,289000,260000,29000
45,3,0,0.0,1,0,105000,100000,5000
45,6,0,21000.0,1,1,228000,284000,-56000
38,5,1,0.0,1,1,397000,394000,3000
59,5,1,0.0,1,1,180000,202000,-22000
34,9,0,69000.0,1,1,446000,323000,123000
19,2,2,6000.0,0,1,91000,86000,5000
36,5,4,107000.0,0,0,180000,266000,-86000
60,3,2,9000.0,0,1,271000,351000,-80000
26,5,2,5000.0,0,1,180000,285000,-105000
45,3,2,7000.0,1,1,180000,232000,-52000
60,2,2,13000.0,0,0,210000,173000,37000
32,2,2,8000.0,0,1,151000,165000,-14000
28,5,4,29000.0,1,0,101000,82000,19000
37,3,0,0.0,1,1,121000,111000,10000
28,3,0,0.0,1,1,121000,107000,14000
38,2,4,642000.0,1,1,1748000,651000,1097000
24,6,5,1150000.0,1,1,3795000,881000,2914000
65,3,2,9000.0,1,0,306000,302000,4000
49,5,4,0.0,2,1,30000,22000,8000
35,2,2,10000.0,0,1,597000,389000,208000
56,2,2,10000.0,1,0,301000,256000,45000
45,2,2,9000.0,0,0,210000,167000,43000
38,2,2,10000.0,1,1,332000,505000,-173000
30,3,4,610000.0,1,0,1506000,1002000,504000
46,2,4,0.0,0,0,180000,130000,50000
23,5,4,906000.0,0,1,2229000,835000,1394000
25,5,3,32500.0,1,1,151000,119000,32000
50,5,2,2000.0,1,1,60000,50000,10000
40,6,2,16000.0,1,1,60000,59000,1000
39,6,5,100000.0,1,1,392000,291000,101000
57,9,2,1000.0,1,1,60000,52000,8000
55,6,2,1000.0,1,1,60000,50000,10000
22,6,3,5000.0,1,1,180000,135000,45000
50,5,4,0.0,1,1,151000,242000,-91000
67,5,4,0.0,0,0,151000,256000,-105000
22,3,2,10000.0,1,0,903000,691000,212000
37,5,2,10000.0,1,1,1205000,886000,319000
35,9,2,19000.0,1,1,1205000,994000,211000
30,5,3,62000.0,2,1,362000,324000,38000
60,6,4,3500.0,1,1,121000,198000,-77000
60,5,2,210000.0,1,1,1205000,965000,240000
54,6,5,8000.0,1,1,392000,364000,28000
30,6,2,1000.0,1,1,60000,47000,13000
63,3,4,0.0,1,1,121000,79000,42000
29,6,3,23000.0,1,1,241000,205000,36000
22,5,2,2000.0,1,1,60000,43000,17000
34,5,2,3000.0,1,1,60000,44000,16000
40,2,2,7000.0,1,1,121000,105000,16000
29,2,2,7000.0,0,0,121000,144000,-23000
35,6,3,520000.0,1,1,1205000,837000,368000
23,5,2,10000.0,1,1,1205000,841000,364000
51,5,2,6500.0,1,1,60000,52000,8000
30,6,2,1000.0,1,0,60000,54000,6000
20,5,4,0.0,1,0,180000,120000,60000
35,6,2,3000.0,1,1,109000,108000,1000
42,5,4,0.0,1,1,180000,111000,69000
57,5,2,10000.0,1,1,1205000,850000,355000
36,6,2,10000.0,1,1,1205000,864000,341000
24,6,5,8000.0,1,1,392000,371000,21000
25,5,4,0.0,0,0,180000,145000,35000
33,9,2,19000.0,1,1,1205000,974000,231000
21,5,0,20000.0,1,1,60000,77000,-17000
40,3,4,0.0,0,1,180000,124000,56000
26,6,2,1000.0,1,0,60000,46000,14000
27,6,2,6000.0,1,0,289000,230000,59000
36,6,4,24500.0,1,1,151000,130000,21000
54,6,2,10000.0,1,0,1807000,1190000,617000
21,5,0,6000.0,1,1,241000,232000,9000
48,9,1,1000.0,1,1,60000,58000,2000
42,5,3,6000.0,1,1,241000,204000,37000
52,11,3,19300.0,1,1,301000,275000,26000
37,9,2,9000.0,1,1,1205000,793000,412000
19,6,2,10000.0,1,1,1807000,1194000,613000
25,6,5,27000.0,1,0,602000,364000,238000
28,6,2,10000.0,1,1,1205000,1006000,199000
28,5,2,2000.0,1,0,60000,61000,-1000
32,5,4,0.0,1,1,151000,111000,40000
34,2,2,5000.0,1,1,60000,94000,-34000
32,6,5,8000.0,1,1,422000,337000,85000
25,3,5,27500.0,1,1,362000,354000,8000
53,3,2,10000.0,1,0,1205000,816000,389000
50,3,2,10000.0,1,0,1205000,889000,316000
42,6,3,6000.0,1,0,241000,219000,22000
35,3,2,6000.0,0,1,121000,111000,10000
25,5,2,10000.0,1,1,1205000,915000,290000
42,6,2,51500.0,1,1,1506000,1224000,282000
30,2,2,7000.0,1,1,121000,87000,34000
52,3,2,10000.0,1,0,1205000,804000,401000
25,5,2,80000.0,1,1,1205000,886000,319000
28,3,2,5000.0,1,1,91000,113000,-22000
51,5,1,0.0,1,1,91000,94000,-3000
66,5,1,6000.0,1,1,241000,280000,-39000
24,6,3,29500.0,1,0,210000,118000,92000
34,5,4,0.0,1,1,180000,134000,46000
30,6,4,139000.0,0,1,602000,490000,112000
55,6,1,0.0,1,1,121000,109000,12000
19,9,0,0.0,1,1,60000,56000,4000
62,9,2,5000.0,0,1,301000,499000,-198000
38,2,2,7000.0,1,1,66000,100000,-34000
33,3,5,7000.0,0,1,180000,281000,-101000
37,9,3,105000.0,0,1,301000,233000,68000
34,9,5,50000.0,1,1,638000,464000,174000
23,6,4,5000.0,1,1,121000,81000,40000
40,6,0,0.0,1,1,60000,73000,-13000
41,6,4,208500.0,1,1,903000,576000,327000
65,6,3,0.0,1,0,645000,603000,42000
60,5,1,0.0,1,1,121000,111000,10000
27,6,3,94000.0,1,0,572000,409000,163000
20,3,1,0.0,1,1,101000,106000,-5000
30,9,3,315700.0,1,1,948000,391000,557000
18,9,3,312000.0,1,0,724000,380000,344000
22,9,3,314400.0,1,0,868000,402000,466000
31,3,4,140000.0,1,1,602000,411000,191000
20,6,5,78000.0,0,1,121000,150000,-29000
36,11,4,132000.0,1,1,524000,326000,198000
42,6,4,82000.0,1,1,481000,347000,134000
30,9,1,0.0,1,0,151000,139000,12000
29,11,1,50000.0,1,0,180000,203000,-23000
26,14,3,63000.0,1,0,271000,200000,71000
27,9,0,500.0,1,0,543000,417000,126000
46,6,4,181000.0,1,1,724000,409000,315000
29,6,4,47000.0,0,0,362000,402000,-40000
40,6,4,85000.0,0,1,602000,460000,142000
30,5,4,0.0,0,0,91000,56000,35000
54,12,4,71000.0,0,1,422000,398000,24000
34,6,4,125000.0,0,1,1205000,573000,632000
28,6,4,1000.0,0,1,91000,70000,21000
62,6,4,32000.0,1,1,60000,40000,20000
32,3,4,15000.0,1,1,60000,44000,16000
21,3,3,30000.0,1,1,60000,75000,-15000
30,6,4,5000.0,0,1,91000,75000,16000
25,9,4,50000.0,1,1,271000,349000,-78000
35,6,4,49500.0,1,1,241000,339000,-98000
35,3,4,50000.0,1,1,241000,215000,26000
51,3,4,93000.0,1,1,180000,122000,58000
23,6,0,10000.0,0,0,392000,388000,4000
40,5,2,24000.0,1,1,127000,137000,-10000
25,5,4,45000.0,0,0,271000,358000,-87000
60,11,4,1095000.0,1,0,362000,616000,-254000
31,5,4,0.0,0,0,180000,277000,-97000
25,6,4,130000.0,1,1,481000,425000,56000
63,6,4,40000.0,1,1,121000,93000,28000
30,6,3,316500.0,1,1,994000,497000,497000
18,9,3,316500.0,1,0,994000,467000,527000
25,9,3,315000.0,1,1,903000,363000,540000
25,5,4,218000.0,1,0,1085000,686000,399000
46,6,4,215000.0,1,1,873000,563000,310000
30,11,3,315000.0,1,1,903000,506000,397000
23,5,3,316000.0,1,1,964000,565000,399000
32,9,3,315000.0,1,1,903000,462000,441000
22,6,4,203000.0,1,1,939000,539000,400000
58,11,4,209000.0,1,1,1007000,670000,337000
62,3,5,50000.0,1,1,724000,668000,56000
30,9,4,10500.0,1,1,91000,82000,9000
25,5,4,4000.0,1,1,301000,261000,40000
29,5,4,100000.0,1,1,241000,329000,-88000
46,3,4,5000.0,1,1,91000,68000,23000
27,5,4,50000.0,1,0,121000,80000,41000
32,3,5,55000.0,1,0,903000,652000,251000
40,6,4,70000.0,1,1,180000,292000,-112000
42,5,5,9000.0,1,1,472000,273000,199000
36,5,5,8000.0,1,0,432000,274000,158000
42,5,5,39000.0,1,1,498000,406000,92000
37,5,5,105000.0,1,1,763000,520000,243000
20,5,1,5000.0,1,1,72000,96000,-24000
28,5,5,9000.0,1,1,532000,290000,242000
27,4,1,5000.0,1,1,80000,79000,1000
42,5,5,8000.0,1,1,432000,257000,175000
36,5,5,9000.0,1,0,452000,302000,150000
58,5,5,7000.0,2,1,281000,234000,47000
18,4,5,9000.0,1,1,402000,334000,68000
48,6,3,7000.0,1,1,360000,264000,96000
26,6,0,0.0,0,1,280000,264000,16000
50,5,5,70000.0,1,1,914000,508000,406000
23,4,3,347500.0,1,1,964000,634000,330000
45,4,3,370000.0,1,1,653000,603000,50000
32,5,4,114000.0,1,1,602000,361000,241000
33,6,5,8000.0,1,0,400000,379000,21000
43,5,5,8000.0,1,1,438000,306000,132000
55,5,5,2000.0,1,1,60000,98000,-38000
30,4,5,95000.0,1,1,702000,483000,219000
38,5,5,7000.0,2,1,301000,302000,-1000
22,2,3,235000.0,0,1,723000,466000,257000
40,5,1,0.0,1,1,121000,158000,-37000
36,5,5,120000.0,0,1,803000,554000,249000
20,4,3,190000.0,1,0,964000,578000,386000
36,5,3,726600.0,1,1,1606000,874000,732000
60,4,1,0.0,0,0,121000,155000,-34000
37,2,2,234000.0,1,0,1245000,806000,439000
65,4,3,220000.0,1,0,1105000,570000,535000
30,4,3,100000.0,1,1,602000,419000,183000
37,5,2,58000.0,1,1,341000,684000,-343000
41,4,2,9000.0,2,1,482000,337000,145000
32,5,5,9000.0,2,1,602000,417000,185000
38,2,2,2000.0,1,1,29000,26000,3000
40,6,1,0.0,1,1,89000,85000,4000
65,4,1,0.0,0,1,121000,137000,-16000
45,5,1,0.0,1,1,76000,72000,4000
56,4,3,329000.0,1,1,994000,666000,328000
31,5,3,52000.0,1,1,362000,278000,84000
24,1,3,0.0,1,1,72000,63000,9000
40,5,3,954500.0,1,1,2410000,1221000,1189000
30,5,1,80500.0,1,1,153000,192000,-39000
27,5,1,0.0,1,0,72000,65000,7000
38,4,3,39000.0,1,1,358000,298000,60000
24,5,3,179000.0,1,0,693000,483000,210000
28,5,1,0.0,1,1,68000,75000,-7000
45,6,3,677500.0,1,1,1635000,916000,719000
26,6,5,60000.0,1,1,783000,517000,266000
61,4,1,26000.0,1,1,178000,194000,-16000
36,6,3,626000.0,1,0,1265000,819000,446000
30,4,3,698800.0,1,1,1566000,975000,591000
29,6,3,181000.0,1,1,723000,424000,299000
30,6,0,0.0,1,1,112000,95000,17000
35,5,5,3000.0,1,0,100000,126000,-26000
34,5,1,0.0,1,1,201000,209000,-8000
31,4,5,6000.0,1,0,151000,179000,-28000
28,4,5,7700.0,2,1,241000,280000,-39000
62,5,0,0.0,1,0,153000,156000,-3000
26,4,1,0.0,1,1,72000,83000,-11000
39,8,5,2000.0,1,0,100000,161000,-61000
50,4,1,0.0,1,1,121000,109000,12000
36,4,1,0.0,0,1,96000,110000,-14000
34,2,2,10000.0,1,1,1005000,731000,274000
18,6,3,210000.0,1,1,964000,543000,421000
28,4,5,95000.0,1,1,723000,540000,183000
27,5,1,17000.0,1,0,68000,71000,-3000
25,5,5,62000.0,1,1,362000,387000,-25000
40,5,4,155000.0,1,1,863000,453000,410000
30,4,1,49000.0,1,1,72000,70000,2000
59,4,1,34000.0,1,1,64000,60000,4000
32,4,3,106000.0,1,1,602000,396000,206000
30,4,5,131500.0,1,1,904000,487000,417000
30,4,5,60000.0,1,1,362000,326000,36000
18,4,4,184000.0,1,1,653000,384000,269000
31,5,1,0.0,1,0,321000,234000,87000
29,5,5,9000.0,1,1,633000,556000,77000
36,6,1,0.0,1,1,301000,263000,38000
45,4,1,20000.0,2,1,93000,122000,-29000
55,5,4,69000.0,2,1,421000,244000,177000
26,4,5,8000.0,1,1,301000,323000,-22000
35,5,5,48000.0,2,1,643000,492000,151000
27,5,5,18000.0,2,0,402000,333000,69000
28,5,3,95000.0,2,1,602000,507000,95000
27,5,5,7000.0,1,0,301000,269000,32000
55,5,5,17000.0,2,1,301000,286000,15000
39,4,5,135000.0,1,1,641000,414000,227000
40,2,2,9000.0,2,1,201000,185000,16000
40,4,0,0.0,1,1,219000,246000,-27000
35,1,2,4000.0,2,1,29000,26000,3000
59,5,5,110000.0,1,1,813000,601000,212000
19,4,3,100000.0,0,1,602000,521000,81000
32,6,3,99000.0,1,1,582000,460000,122000
52,5,4,66000.0,1,1,362000,236000,126000
23,4,1,50000.0,1,1,221000,272000,-51000
50,5,2,8000.0,2,1,402000,317000,85000
40,4,2,9000.0,2,0,402000,346000,56000
58,5,3,194000.0,1,1,844000,568000,276000
29,5,5,34000.0,1,1,482000,325000,157000
50,4,1,0.0,1,0,201000,246000,-45000
45,4,1,0.0,1,1,131000,171000,-40000
42,4,3,210000.0,1,1,1105000,529000,576000
22,5,1,0.0,1,1,301000,319000,-18000
35,5,5,9000.0,1,1,653000,465000,188000
35,5,5,57000.0,1,1,301000,272000,29000
40,2,5,10000.0,1,1,653000,452000,201000
35,5,3,41000.0,1,1,434000,337000,97000
29,5,5,9000.0,1,1,472000,296000,176000
35,5,5,9000.0,1,0,634000,438000,196000
52,5,5,7000.0,1,1,301000,319000,-18000
26,5,1,20000.0,1,1,183000,182000,1000
29,6,1,0.0,1,1,301000,217000,84000
23,4,4,155000.0,1,1,755000,445000,310000
31,2,3,356500.0,1,0,723000,368000,355000
40,4,3,405000.0,1,1,844000,477000,367000
33,5,5,210000.0,2,1,763000,504000,259000
46,4,1,23000.0,1,1,72000,68000,4000
38,5,1,7500.0,1,1,68000,59000,9000
50,8,4,185000.0,1,1,683000,392000,291000
43,5,5,54000.0,2,1,502000,390000,112000
27,5,5,7000.0,1,0,301000,261000,40000
27,5,1,0.0,1,1,281000,212000,69000
38,2,1,0.0,1,1,57000,54000,3000
38,4,1,0.0,1,1,241000,183000,58000
32,5,5,10000.0,1,1,733000,519000,214000
34,6,5,7000.0,1,1,362000,307000,55000
29,5,1,0.0,1,1,261000,240000,21000
35,4,4,119000.0,1,1,454000,274000,180000
38,4,5,24000.0,2,1,326000,292000,34000
27,4,5,10000.0,0,0,733000,499000,234000
37,5,5,9000.0,1,1,653000,476000,177000
65,5,5,22000.0,1,0,281000,234000,47000
26,5,3,72000.0,1,0,582000,376000,206000
30,5,1,0.0,1,1,72000,97000,-25000
33,5,1,0.0,1,1,144000,175000,-31000
55,5,3,180000.0,1,1,702000,442000,260000
22,6,3,99000.0,1,1,602000,380000,222000
30,2,1,0.0,1,0,52000,61000,-9000
31,2,1,0.0,0,0,80000,76000,4000
65,4,3,39000.0,1,1,362000,291000,71000
35,4,1,0.0,1,1,100000,96000,4000
49,5,2,40000.0,1,0,1005000,783000,222000
38,2,3,9000.0,1,1,201000,345000,-144000
32,4,2,10000.0,1,1,563000,398000,165000
32,5,5,50000.0,1,0,402000,359000,43000
30,4,4,24000.0,1,1,201000,131000,70000
32,2,3,0.0,1,1,151000,137000,14000
37,5,5,4000.0,1,1,121000,149000,-28000
55,5,1,1500.0,1,1,72000,81000,-9000
40,8,2,57000.0,1,1,402000,339000,63000
43,4,5,28800.0,0,1,160000,169000,-9000
19,2,5,7000.0,1,1,100000,90000,10000
30,5,1,0.0,1,1,80000,66000,14000
29,4,5,10000.0,1,1,693000,439000,254000
38,8,5,180000.0,1,1,971000,761000,210000
45,6,4,230000.0,1,1,1016000,558000,458000
19,6,4,323000.0,1,1,1137000,663000,474000
30,5,4,191000.0,2,0,815000,455000,360000
39,4,5,20000.0,2,1,301000,303000,-2000
33,4,5,10000.0,1,1,723000,427000,296000
18,8,5,34000.0,2,1,602000,459000,143000
31,4,3,48000.0,1,1,442000,281000,161000
28,5,3,310000.0,1,0,844000,532000,312000
18,5,3,344400.0,1,0,723000,436000,287000
35,4,5,4000.0,1,1,100000,89000,11000
34,5,1,2400.0,1,1,72000,74000,-2000
35,4,2,9000.0,1,1,452000,348000,104000
30,4,3,109000.0,1,1,362000,272000,90000
31,6,5,10000.0,1,1,301000,258000,43000
22,6,5,7000.0,1,1,301000,266000,35000
37,5,5,10000.0,1,1,702000,489000,213000
32,5,5,9000.0,1,1,653000,437000,216000
22,5,1,0.0,1,1,72000,63000,9000
35,2,1,0.0,0,1,60000,57000,3000
70,6,5,8000.0,1,1,402000,376000,26000
32,5,1,0.0,1,1,144000,189000,-45000
21,5,3,311700.0,1,0,702000,222000,480000
43,5,1,0.0,1,1,201000,199000,2000
35,4,4,85000.0,1,1,362000,253000,109000
35,2,5,6000.0,1,1,80000,86000,-6000
24,5,5,3000.0,1,0,109000,101000,8000
36,2,5,3000.0,1,1,40000,64000,-24000
23,4,3,255000.0,1,1,641000,314000,327000
38,2,5,3000.0,1,1,40000,48000,-8000
65,6,5,6000.0,1,1,261000,306000,-45000
25,6,1,34000.0,1,1,137000,145000,-8000
28,5,1,43000.0,1,0,86000,83000,3000
38,2,3,67000.0,1,1,100000,162000,-62000
18,5,3,425000.0,1,0,1044000,469000,575000
24,5,3,311900.0,1,0,715000,359000,356000
38,6,5,9000.0,1,1,734000,456000,278000
61,5,3,92000.0,2,1,554000,463000,91000
33,5,1,18000.0,1,1,217000,220000,-3000
42,8,1,0.0,0,1,142000,164000,-22000
40,6,3,264200.0,1,1,614000,226000,388000
40,4,5,8000.0,1,1,301000,265000,36000
35,5,5,99000.0,1,1,643000,379000,264000
30,6,1,0.0,1,1,178000,175000,3000
28,6,3,139000.0,1,1,771000,567000,204000
40,4,1,0.0,1,1,40000,34000,6000
38,4,1,0.0,1,1,201000,210000,-9000
24,5,5,40000.0,1,1,301000,295000,6000
36,5,5,7000.0,1,1,301000,346000,-45000
60,4,5,8000.0,1,1,301000,288000,13000
26,4,1,37290.0,1,1,209000,181000,28000
38,10,3,320000.0,1,1,1165000,518000,647000
35,4,1,70000.0,1,1,72000,59000,13000
21,6,3,212000.0,1,1,800000,524000,276000
22,6,4,218500.0,1,1,695000,453000,242000
23,6,1,5000.0,1,1,89000,75000,14000
23,5,4,125000.0,1,1,795000,413000,382000
32,2,3,210000.0,1,1,482000,378000,104000
21,6,1,0.0,1,1,80000,75000,5000
57,4,5,109000.0,1,1,520000,376000,144000
27,5,5,100000.0,1,0,803000,699000,104000
45,8,1,0.0,1,1,128000,146000,-18000
36,5,5,1100000.0,1,0,1005000,855000,150000
23,5,3,72000.0,1,1,482000,202000,280000
35,6,3,427300.0,1,1,1044000,443000,601000
29,4,4,33000.0,1,0,301000,256000,45000
32,8,4,148000.0,0,0,595000,341000,254000
21,6,3,184000.0,1,1,1008000,530000,478000
35,2,2,4000.0,1,1,51000,68000,-17000
65,6,5,100350.0,1,1,924000,703000,221000
37,6,3,189000.0,1,1,802000,479000,323000
18,5,5,9000.0,1,0,462000,335000,127000
20,8,1,0.0,0,1,121000,147000,-26000
35,8,2,29000.0,1,1,999000,654000,345000
38,6,1,2000.0,1,0,84000,90000,-6000
53,5,1,0.0,1,1,102000,101000,1000
37,5,3,62000.0,1,1,362000,327000,35000
40,6,1,15000.0,2,1,96000,90000,6000
30,5,1,0.0,1,1,72000,71000,1000
38,8,1,0.0,1,1,121000,145000,-24000
50,4,1,0.0,1,1,121000,98000,23000
32,5,5,10000.0,1,0,1005000,614000,391000
36,6,1,0.0,0,1,121000,100000,21000
40,11,4,662000.0,1,1,1418000,981000,437000
36,5,5,7000.0,1,1,301000,254000,47000
30,5,3,5000.0,1,0,160000,296000,-136000
29,5,3,93000.0,1,1,542000,281000,261000
27,5,3,229000.0,1,1,643000,332000,311000
36,4,2,140730.0,1,1,1266000,1173000,93000
70,5,1,5000.0,0,1,280000,246000,34000
60,4,3,780000.0,1,0,1807000,1111000,696000
30,6,1,5000.0,1,1,84000,80000,4000
35,5,3,149000.0,1,1,502000,217000,285000
60,5,3,243000.0,2,1,988000,494000,494000
48,4,5,0.0,0,1,277000,291000,-14000
42,4,3,3500.0,1,1,307000,294000,13000
32,2,3,110000.0,1,1,482000,315000,167000
32,4,3,43000.0,1,0,362000,325000,37000
25,5,3,211000.0,1,1,884000,463000,421000
50,6,0,5000.0,1,1,362000,326000,36000
35,5,1,8000.0,1,1,90000,80000,10000
50,2,3,160000.0,1,1,482000,411000,71000
23,4,3,70000.0,1,0,482000,338000,144000
24,5,3,74000.0,1,1,482000,366000,116000
30,5,5,240000.0,1,1,802000,651000,151000
45,4,3,8000.0,1,1,301000,238000,63000
32,5,3,210000.0,1,1,702000,388000,314000
22,2,4,69000.0,1,0,372000,229000,143000
32,5,1,0.0,0,1,83000,89000,-6000
25,6,3,173000.0,1,0,643000,298000,345000
45,4,3,179000.0,1,1,362000,261000,101000
55,6,1,8000.0,0,1,201000,342000,-141000
31,4,3,108000.0,1,0,582000,344000,238000
18,5,3,240000.0,1,1,763000,607000,156000
28,5,5,35000.0,1,1,180000,237000,-57000
32,5,3,88000.0,0,0,531000,356000,175000
29,6,5,610000.0,1,1,1005000,917000,88000
24,5,3,65000.0,1,0,402000,343000,59000
38,4,5,310000.0,1,1,1005000,683000,322000
28,6,2,70800.0,0,0,20000,24000,-4000
36,8,5,23000.0,1,1,702000,449000,253000
35,2,3,23000.0,1,1,140000,149000,-9000
32,5,2,32000.0,1,1,301000,226000,75000
34,5,5,451000.0,1,0,1406000,759000,647000
28,5,3,4000.0,1,0,121000,134000,-13000
29,2,4,0.0,1,0,20000,25000,-5000
35,5,3,4000.0,1,1,121000,175000,-54000
28,2,3,7000.0,1,0,121000,112000,9000
26,2,3,9000.0,1,0,180000,169000,11000
29,5,5,9000.0,1,0,482000,267000,215000
34,5,4,0.0,1,1,301000,175000,126000
55,6,3,222000.0,1,1,763000,476000,287000
38,5,5,7000.0,1,1,281000,279000,2000
20,5,5,9000.0,1,0,472000,266000,206000
26,5,5,57000.0,1,1,301000,283000,18000
33,5,5,58000.0,1,1,362000,303000,59000
32,4,3,36000.0,2,1,337000,280000,57000
36,2,5,10000.0,1,1,472000,361000,111000
26,5,5,8000.0,1,0,432000,305000,127000
20,4,2,1000.0,1,0,2000,5000,-3000
32,5,3,50000.0,1,0,201000,190000,11000
32,5,2,1000.0,1,1,10000,10000,0
38,8,2,7000.0,2,1,402000,291000,111000
50,4,2,33000.0,1,1,281000,695000,-414000
42,5,2,1000.0,1,1,30000,27000,3000
50,5,5,3000.0,1,1,100000,127000,-27000
30,4,2,1000.0,1,1,20000,15000,5000
52,10,2,15000.0,1,1,309000,731000,-422000
18,5,3,3000.0,1,1,100000,210000,-110000
24,2,2,9000.0,1,1,201000,151000,50000
30,5,3,238000.0,1,0,803000,436000,367000
40,4,1,0.0,1,1,160000,166000,-6000
31,6,5,7000.0,2,1,339000,362000,-23000
32,2,2,3000.0,1,0,34000,44000,-10000
40,4,3,182000.0,0,1,723000,439000,284000
18,5,5,185000.0,2,1,702000,641000,61000
26,5,3,112500.0,1,1,362000,297000,65000
29,8,1,3000.0,1,1,109000,119000,-10000
45,8,1,37000.0,1,1,219000,163000,56000
30,9,1,16500.0,1,0,130000,109000,21000
30,8,1,16500.0,1,1,244000,201000,43000
30,9,1,22500.0,1,1,207000,171000,36000
29,8,3,11000.0,1,0,106000,120000,-14000
26,4,5,49000.0,1,1,128000,138000,-10000
19,3,2,8000.0,1,1,51000,65000,-14000
27,4,5,37000.0,1,1,118000,138000,-20000
19,9,3,22500.0,1,1,207000,217000,-10000
30,9,1,4800.0,1,1,144000,128000,16000
36,8,5,73000.0,1,1,306000,285000,21000
30,4,3,32000.0,1,1,207000,153000,54000
50,5,1,17000.0,1,0,121000,118000,3000
19,13,3,99500.0,1,1,508000,315000,193000
25,5,5,33400.0,1,1,160000,143000,17000
30,8,4,49500.0,1,0,301000,209000,92000
45,11,4,66000.0,1,1,362000,239000,123000
75,5,4,51000.0,1,1,281000,181000,100000
50,8,3,30500.0,1,1,241000,190000,51000
38,4,4,29500.0,1,1,301000,207000,94000
37,3,4,36000.0,1,1,241000,164000,77000
30,5,4,15000.0,1,1,193000,124000,69000
20,8,4,105500.0,1,1,502000,326000,176000
35,14,4,56000.0,1,1,402000,276000,126000
35,10,4,65000.0,1,1,362000,268000,94000
32,8,4,79000.0,1,0,522000,296000,226000
32,9,4,92000.0,1,1,362000,245000,117000
39,8,3,339500.0,0,1,964000,665000,299000
50,11,2,69000.0,0,0,723000,469000,254000
38,10,2,44000.0,0,1,964000,777000,187000
30,8,4,76000.0,2,1,502000,311000,191000
28,8,4,30000.0,0,1,301000,217000,84000
55,4,3,318000.0,0,1,723000,406000,317000
29,10,1,20000.0,0,0,281000,203000,78000
38,4,1,15000.0,2,0,241000,237000,4000
30,10,3,200000.0,0,1,1205000,715000,490000
26,11,4,55000.0,0,1,362000,247000,115000
26,8,1,30000.0,2,0,402000,298000,104000
20,9,3,250000.0,0,1,723000,264000,459000
37,4,1,6000.0,2,1,193000,196000,-3000
30,8,1,15000.0,2,1,193000,179000,14000
55,9,4,83000.0,2,0,362000,247000,115000
66,9,3,190000.0,2,1,1005000,485000,520000
35,10,4,82000.0,1,1,394000,285000,109000
27,9,4,71000.0,1,1,321000,209000,112000
35,4,1,31000.0,1,1,180000,183000,-3000
36,4,4,40000.0,1,1,241000,154000,87000
60,5,4,50000.0,1,1,362000,212000,150000
34,5,4,45000.0,1,1,281000,190000,91000
32,8,1,20000.0,1,1,241000,209000,32000
40,9,4,90000.0,1,1,362000,275000,87000
50,3,3,14000.0,1,1,244000,204000,40000
33,10,4,54000.0,0,0,321000,188000,133000
25,5,1,15000.0,0,0,241000,178000,63000
24,8,1,9700.0,0,1,442000,350000,92000
22,5,4,49000.0,1,1,402000,292000,110000
48,5,4,90000.0,1,1,362000,253000,109000
32,8,1,40000.0,0,1,321000,282000,39000
40,4,4,25000.0,1,1,241000,169000,72000
41,5,4,93000.0,0,1,362000,225000,137000
27,9,4,143000.0,0,1,502000,301000,201000
24,8,1,25000.0,0,1,284000,236000,48000
42,8,4,82000.0,0,1,301000,205000,96000
40,3,4,25000.0,1,1,193000,121000,72000
37,4,4,0.0,1,1,201000,300000,-99000
37,3,1,0.0,1,0,60000,57000,3000
48,1,5,10000.0,1,1,180000,185000,-5000
25,3,4,63000.0,1,0,60000,42000,18000
33,3,4,0.0,1,0,101000,88000,13000
22,3,4,0.0,1,1,120000,201000,-81000
28,1,4,0.0,0,1,120000,95000,25000
24,5,4,0.0,1,1,113000,73000,40000
33,3,4,0.0,1,1,40000,29000,11000
35,3,4,0.0,1,0,60000,45000,15000
26,4,4,0.0,1,1,180000,271000,-91000
38,5,0,0.0,2,0,120000,122000,-2000
26,4,0,0.0,1,1,120000,132000,-12000
23,5,3,7000.0,1,1,277000,188000,89000
28,5,4,0.0,1,0,180000,227000,-47000
30,3,0,0.0,1,0,120000,114000,6000
30,8,3,4000.0,1,1,224000,174000,50000
25,4,0,0.0,1,1,120000,109000,11000
35,1,2,10000.0,1,1,361000,392000,-31000
34,4,4,0.0,1,1,232000,134000,98000
50,1,2,8500.0,1,1,81000,69000,12000
51,5,3,0.0,1,1,410000,458000,-48000
34,4,4,0.0,1,1,120000,90000,30000
30,8,4,0.0,1,1,101000,90000,11000
21,4,4,54000.0,0,1,321000,230000,91000
28,4,3,3000.0,0,1,81000,209000,-128000
28,5,5,8000.0,0,1,341000,262000,79000
50,4,4,0.0,1,1,24000,15000,9000
40,3,4,0.0,1,1,180000,229000,-49000
33,4,4,0.0,1,1,120000,88000,32000
29,3,4,0.0,1,1,201000,220000,-19000
24,4,0,0.0,1,0,262000,278000,-16000
60,3,4,0.0,1,1,180000,155000,25000
38,4,4,0.0,1,1,246000,222000,24000
20,5,4,67000.0,1,1,388000,271000,117000
23,3,3,57000.0,1,1,361000,585000,-224000
34,3,5,0.0,1,1,241000,242000,-1000
45,3,4,0.0,1,1,180000,177000,3000
38,4,4,0.0,1,1,241000,352000,-111000
37,4,4,0.0,1,1,101000,52000,49000
24,4,4,0.0,1,1,120000,88000,32000
37,5,4,71000.0,1,0,442000,489000,-47000
27,3,5,0.0,1,1,101000,91000,10000
25,4,4,0.0,1,1,81000,49000,32000
26,4,4,0.0,1,0,101000,79000,22000
25,8,3,0.0,1,1,1064000,737000,327000
31,3,4,0.0,1,1,81000,57000,24000
25,4,3,5000.0,1,1,140000,150000,-10000
29,5,3,5000.0,0,1,160000,611000,-451000
70,3,5,6000.0,2,1,120000,178000,-58000
27,9,3,17000.0,1,1,201000,336000,-135000
35,3,5,6000.0,1,1,120000,193000,-73000
30,1,4,0.0,1,1,160000,104000,56000
20,4,3,6000.0,1,1,180000,138000,42000
33,5,5,25000.0,1,0,140000,126000,14000
70,8,4,0.0,1,1,233000,135000,98000
55,3,4,0.0,1,1,177000,111000,66000
26,8,1,0.0,1,0,221000,162000,59000
29,4,4,0.0,1,1,120000,79000,41000
46,5,3,5000.0,1,1,180000,140000,40000
62,9,0,0.0,1,1,229000,218000,11000
40,5,4,64000.0,0,1,314000,282000,32000
70,8,4,0.0,1,1,180000,169000,11000
22,8,4,61000.0,1,1,101000,88000,13000
49,4,0,0.0,1,1,229000,192000,37000
25,3,5,7000.0,0,1,180000,157000,23000
36,8,4,50000.0,1,0,120000,71000,49000
27,8,4,0.0,1,0,140000,80000,60000
28,9,0,400000.0,1,1,140000,142000,-2000
27,3,4,0.0,1,1,180000,139000,41000
30,4,4,204000.0,1,1,101000,69000,32000
47,5,2,14000.0,0,1,180000,222000,-42000
29,5,4,0.0,0,1,180000,110000,70000
54,12,4,0.0,0,1,221000,173000,48000
55,4,4,0.0,1,1,302000,247000,55000
30,11,4,0.0,0,1,160000,129000,31000
29,13,4,0.0,0,1,221000,142000,79000
24,9,4,0.0,0,1,177000,155000,22000
52,5,4,0.0,0,1,180000,141000,39000
50,5,4,0.0,1,1,140000,99000,41000
27,8,4,0.0,0,0,180000,149000,31000
30,8,4,0.0,0,1,302000,241000,61000
28,8,4,0.0,0,0,221000,154000,67000
28,8,4,0.0,0,1,160000,116000,44000
31,4,4,0.0,1,1,160000,127000,33000
33,4,4,0.0,1,1,241000,193000,48000
25,5,4,0.0,1,1,261000,198000,63000
25,5,4,0.0,1,1,261000,210000,51000
29,3,4,0.0,1,1,241000,152000,89000
45,5,2,7000.0,1,1,302000,221000,81000
49,3,4,0.0,1,0,180000,168000,12000
38,5,0,0.0,1,1,120000,115000,5000
40,1,3,0.0,1,1,101000,93000,8000
40,3,0,0.0,1,1,120000,108000,12000
35,4,0,0.0,1,1,120000,128000,-8000
26,1,2,6000.0,1,1,40000,49000,-9000
50,3,0,0.0,1,1,120000,122000,-2000
75,4,0,5000.0,1,1,120000,127000,-7000
35,1,3,0.0,1,1,120000,111000,9000
18,3,0,0.0,1,1,120000,114000,6000
47,3,0,0.0,1,1,120000,107000,13000
33,8,4,0.0,0,1,180000,154000,26000
20,4,4,0.0,1,1,180000,133000,47000
45,8,4,0.0,0,1,180000,105000,75000
43,4,4,0.0,0,1,160000,108000,52000
65,4,4,0.0,0,1,180000,152000,28000
20,5,4,0.0,0,1,180000,108000,72000
29,5,4,0.0,1,1,180000,155000,25000
22,4,4,0.0,1,1,140000,86000,54000
33,4,4,0.0,0,1,180000,136000,44000
22,5,3,51000.0,0,1,321000,277000,44000
25,9,4,90000.0,0,1,180000,157000,23000
21,5,2,2000.0,1,1,81000,64000,17000
30,8,4,0.0,0,1,201000,149000,52000
40,4,2,6000.0,1,1,180000,175000,5000
30,5,3,72000.0,0,1,470000,250000,220000
40,11,4,0.0,0,1,180000,116000,64000
19,4,4,0.0,2,1,302000,364000,-62000
35,4,4,40000.0,2,1,302000,280000,22000
71,9,1,0.0,0,0,221000,182000,39000
30,5,4,0.0,0,1,140000,210000,-70000
30,4,4,55000.0,2,1,341000,309000,32000
19,4,5,8000.0,1,1,321000,293000,28000
28,3,3,77000.0,1,1,450000,297000,153000
40,5,4,55000.0,0,1,341000,221000,120000
35,9,3,3000.0,0,1,148000,116000,32000
36,4,4,0.0,2,1,302000,365000,-63000
40,5,4,0.0,1,1,270000,156000,114000
25,8,4,0.0,2,1,302000,312000,-10000
32,8,4,0.0,1,1,282000,212000,70000
50,3,4,0.0,2,1,302000,400000,-98000
40,9,5,2000.0,0,1,142000,184000,-42000
35,3,4,0.0,0,1,82000,102000,-20000
28,3,0,0.0,0,1,58000,57000,1000
34,8,4,0.0,1,1,74000,47000,27000
26,8,2,2000.0,0,1,120000,113000,7000
40,5,0,0.0,0,1,87000,79000,8000
20,3,2,9000.0,1,1,392000,286000,106000
25,5,3,4000.0,0,1,116000,159000,-43000
18,5,4,0.0,1,1,221000,134000,87000
21,4,3,45000.0,0,1,277000,186000,91000
26,3,4,0.0,2,1,120000,106000,14000
30,8,4,0.0,1,1,250000,176000,74000
30,4,4,0.0,0,1,101000,90000,11000
24,3,4,0.0,0,1,221000,148000,73000
30,4,4,5000.0,1,0,277000,180000,97000
54,8,0,0.0,1,1,140000,137000,3000
45,1,2,10000.0,2,1,201000,164000,37000
26,3,5,100000.0,1,1,980000,768000,212000
56,1,2,10000.0,1,0,145000,141000,4000
27,4,2,5000.0,1,1,116000,172000,-56000
28,3,5,10000.0,1,1,1004000,814000,190000
21,1,4,0.0,0,1,302000,176000,126000
30,1,2,10000.0,2,1,160000,149000,11000
32,1,2,10000.0,2,1,160000,201000,-41000
28,1,2,10000.0,1,1,145000,126000,19000
23,1,3,100000.0,2,1,88000,75000,13000
27,5,3,652300.0,1,1,1526000,741000,785000
23,1,2,10000.0,0,1,145000,126000,19000
29,5,2,10000.0,1,1,924000,696000,228000
40,1,3,82000.0,1,1,482000,325000,157000
28,5,5,0.0,0,1,302000,218000,84000
22,1,2,20000.0,2,1,160000,158000,2000
35,5,3,532000.0,1,1,1326000,789000,537000
29,1,2,10000.0,2,0,160000,185000,-25000
36,1,2,10000.0,2,1,160000,158000,2000
29,3,2,62000.0,1,0,96000,83000,13000
33,1,2,22600.0,2,1,160000,185000,-25000
36,3,3,182000.0,0,1,724000,392000,332000
28,3,2,5000.0,1,1,96000,141000,-45000
30,5,5,0.0,0,1,81000,80000,1000
45,1,2,10000.0,2,1,160000,171000,-11000
27,8,2,2000.0,1,1,96000,151000,-55000
28,1,2,10000.0,2,1,160000,191000,-31000
68,1,2,10000.0,1,0,145000,125000,20000
32,1,2,9000.0,1,1,116000,185000,-69000
40,3,3,82000.0,0,1,482000,344000,138000
26,1,5,0.0,0,1,81000,71000,10000
24,1,5,0.0,0,1,81000,70000,11000
36,1,2,10000.0,2,1,201000,185000,16000
21,1,2,9000.0,2,1,96000,121000,-25000
36,1,4,0.0,0,1,81000,63000,18000
57,1,2,10000.0,1,1,145000,141000,4000
25,5,2,3000.0,1,1,96000,143000,-47000
60,1,2,10000.0,2,0,160000,185000,-25000
38,1,2,10000.0,1,1,145000,156000,-11000
27,1,2,10000.0,2,1,160000,164000,-4000
30,1,4,15000.0,0,1,81000,130000,-49000
68,1,2,10000.0,2,1,160000,167000,-7000
32,1,2,14500.0,1,1,145000,134000,11000
42,3,5,5000.0,0,1,101000,127000,-26000
50,1,2,10000.0,2,1,160000,159000,1000
52,1,5,10000.0,1,1,803000,643000,160000
50,1,2,10000.0,2,1,201000,174000,27000
28,3,5,5000.0,0,0,88000,114000,-26000
31,1,3,82000.0,0,1,482000,339000,143000
31,5,3,315300.0,0,0,924000,624000,300000
52,1,2,10000.0,0,1,145000,171000,-26000
35,1,2,10000.0,2,1,160000,180000,-20000
63,5,5,0.0,0,1,101000,101000,0
18,1,2,10000.0,0,1,145000,139000,6000
24,3,4,140000.0,2,1,602000,359000,243000
30,3,2,5000.0,1,1,96000,135000,-39000
28,5,3,518900.0,1,1,1140000,463000,677000
48,1,2,10000.0,1,1,145000,150000,-5000
40,1,3,82000.0,1,1,482000,331000,151000
21,1,3,208000.0,1,0,980000,638000,342000
29,3,2,5000.0,1,0,96000,103000,-7000
21,1,2,10000.0,0,0,145000,156000,-11000
48,1,3,82000.0,1,1,482000,351000,131000
28,5,4,0.0,0,1,81000,48000,33000
32,3,2,5000.0,0,1,96000,150000,-54000
35,4,3,316700.0,1,1,1004000,540000,464000
40,4,4,20000.0,1,1,120000,82000,38000
39,3,1,0.0,1,1,25000,23000,2000
45,4,2,19200.0,0,1,1808000,1119000,689000
24,5,0,0.0,1,1,40000,35000,5000
45,4,5,65000.0,1,1,683000,507000,176000
25,5,1,49000.0,1,0,40000,33000,7000
35,3,0,13000.0,1,0,201000,233000,-32000
56,4,2,7000.0,1,1,201000,181000,20000
26,3,2,10000.0,1,1,664000,515000,149000
55,4,2,8000.0,2,1,341000,244000,97000
58,4,0,21000.0,1,1,241000,226000,15000
25,4,2,9000.0,1,1,502000,362000,140000
25,3,5,60800.0,2,1,482000,472000,10000
70,4,3,10000.0,0,1,482000,405000,77000
35,5,2,9000.0,1,1,602000,679000,-77000
50,5,4,0.0,1,1,40000,35000,5000
30,5,1,0.0,1,1,81000,100000,-19000
60,4,2,10000.0,2,1,602000,548000,54000
18,8,1,0.0,1,1,40000,35000,5000
32,4,4,69000.0,1,1,101000,128000,-27000
35,4,1,0.0,1,1,49000,59000,-10000
30,4,2,10000.0,1,1,637000,624000,13000
25,3,2,10000.0,2,1,743000,509000,234000
28,3,4,0.0,1,1,4000,4000,0
46,4,2,3000.0,1,0,81000,93000,-12000
23,5,2,16300.0,2,0,2009000,845000,1164000
50,4,5,443500.0,0,1,1606000,954000,652000
68,4,2,21000.0,0,1,8000,6000,2000
30,4,4,0.0,2,0,12000,10000,2000
38,4,3,208800.0,0,0,964000,534000,430000
39,8,2,8000.0,2,1,505000,563000,-58000
60,5,1,0.0,1,0,81000,77000,4000
32,4,0,0.0,1,1,36000,31000,5000
44,5,0,0.0,1,1,28000,27000,1000
30,4,2,10000.0,2,1,611000,740000,-129000
48,5,2,9000.0,1,0,602000,689000,-87000
27,5,4,74000.0,1,1,321000,228000,93000
30,8,4,138000.0,1,1,602000,374000,228000
30,4,3,2900000.0,1,0,2410000,1369000,1041000
50,3,3,644000.0,1,1,1446000,567000,879000
72,4,4,124000.0,1,1,602000,326000,276000
18,4,3,316700.0,1,1,1004000,422000,582000
22,8,3,6000.0,1,1,337000,187000,150000
70,5,3,51000.0,1,1,321000,160000,161000
25,4,3,316700.0,1,1,1004000,447000,557000
33,5,3,3110000.0,1,1,3213000,2086000,1127000
19,5,4,139000.0,1,1,602000,370000,232000
56,5,3,51000.0,1,1,321000,237000,84000
48,8,3,60000.0,0,1,361000,322000,39000
29,4,3,57000.0,0,1,361000,218000,143000
25,5,3,89000.0,1,1,602000,221000,381000
32,5,4,190000.0,1,0,803000,508000,295000
32,3,3,8000.0,1,0,241000,182000,59000
70,5,4,139000.0,1,0,602000,314000,288000
40,4,4,54000.0,0,0,321000,199000,122000
31,8,5,9000.0,1,1,803000,700000,103000
34,5,4,139000.0,1,1,602000,390000,212000
36,8,4,64000.0,1,1,361000,216000,145000
48,8,3,7000.0,1,0,482000,200000,282000
30,4,3,62000.0,1,0,402000,217000,185000
62,5,3,61000.0,2,1,402000,498000,-96000
46,4,3,51000.0,1,1,321000,259000,62000
59,9,5,7000.0,1,1,482000,362000,120000
68,1,2,28600.0,1,1,221000,323000,-102000
45,3,2,8000.0,1,0,250000,272000,-22000
69,1,2,10000.0,1,1,180000,219000,-39000
70,3,2,10000.0,1,1,611000,448000,163000
40,3,4,194000.0,2,1,844000,435000,409000
69,3,2,10000.0,1,1,844000,598000,246000
18,5,4,54000.0,1,1,321000,186000,135000
55,5,4,66000.0,1,1,361000,243000,118000
40,4,3,35000.0,1,1,321000,277000,44000
40,8,4,81000.0,1,1,482000,330000,152000
35,8,4,52000.0,1,0,321000,206000,115000
36,8,4,52000.0,1,1,321000,185000,136000
38,4,5,9000.0,1,1,482000,340000,142000
63,8,3,6000.0,1,0,321000,187000,134000
57,4,3,313300.0,1,1,803000,498000,305000
38,5,4,0.0,0,1,120000,85000,35000
21,4,3,81000.0,1,0,482000,377000,105000
37,5,4,0.0,2,1,160000,137000,23000
20,5,3,51000.0,1,0,321000,250000,71000
21,5,3,315000.0,1,1,904000,581000,323000
26,5,3,35000.0,1,1,321000,239000,82000
51,3,3,313300.0,1,1,803000,361000,442000
26,5,4,54000.0,1,1,321000,232000,89000
21,4,3,62000.0,1,0,402000,263000,139000
40,3,1,0.0,1,1,40000,39000,1000
22,5,4,42000.0,1,1,60000,87000,-27000
37,4,4,0.0,1,0,40000,64000,-24000
40,5,4,0.0,1,1,40000,24000,16000
45,1,2,10000.0,1,1,221000,174000,47000
29,3,2,8000.0,2,0,221000,396000,-175000
18,3,2,7000.0,1,0,180000,214000,-34000
42,1,2,10000.0,1,1,502000,402000,100000
21,5,4,66000.0,0,0,361000,318000,43000
30,4,1,0.0,1,0,20000,18000,2000
40,4,4,0.0,1,1,40000,50000,-10000
40,5,4,25000.0,0,1,241000,198000,43000
19,5,4,0.0,1,1,40000,31000,9000
29,1,2,10000.0,1,1,341000,257000,84000
59,4,1,0.0,0,1,81000,99000,-18000
40,5,4,4500.0,1,1,60000,41000,19000
34,3,0,0.0,1,0,12000,13000,-1000
68,4,2,86000.0,1,1,180000,155000,25000
36,3,2,55000.0,1,1,101000,76000,25000
27,5,4,0.0,1,1,49000,36000,13000
48,4,4,0.0,1,0,224000,132000,92000
25,5,1,0.0,1,0,60000,62000,-2000
29,3,5,14000.0,1,1,302000,262000,40000
35,3,2,10000.0,1,1,502000,350000,152000
56,3,2,8000.0,1,1,221000,212000,9000
73,3,2,10000.0,1,1,612000,474000,138000
42,3,2,10000.0,2,1,502000,603000,-101000
32,5,4,54000.0,1,1,321000,189000,132000
36,3,2,8000.0,1,0,224000,254000,-30000
60,3,2,9000.0,2,1,381000,297000,84000
19,4,3,73000.0,1,0,482000,208000,274000
29,3,1,0.0,1,0,49000,48000,1000
50,5,4,139000.0,2,1,602000,355000,247000
44,5,4,139000.0,2,1,602000,345000,257000
50,5,4,0.0,1,1,60000,48000,12000
22,5,3,51000.0,1,0,321000,164000,157000
30,5,4,54000.0,1,1,321000,225000,96000
52,5,1,0.0,1,1,81000,80000,1000
35,5,4,260000.0,2,1,1004000,652000,352000
88,5,5,8000.0,1,1,321000,297000,24000
27,3,3,107000.0,1,1,282000,232000,50000
38,4,1,0.0,1,1,49000,58000,-9000
28,1,2,10000.0,1,1,402000,272000,130000
70,3,1,0.0,1,1,40000,51000,-11000
35,5,4,0.0,1,1,60000,80000,-20000
28,5,4,0.0,1,1,81000,86000,-5000
29,3,2,8000.0,2,1,223000,602000,-379000
55,5,0,0.0,1,1,40000,42000,-2000
58,4,1,0.0,1,0,40000,45000,-5000
40,5,2,21500.0,2,1,341000,512000,-171000
50,3,2,8000.0,2,0,251000,210000,41000
27,3,2,27000.0,1,1,496000,581000,-85000
30,1,2,10000.0,1,0,1004000,736000,268000
35,3,2,7000.0,1,1,180000,200000,-20000
38,3,2,10000.0,1,1,612000,524000,88000
29,3,3,543000.0,1,1,1406000,879000,527000
35,3,2,7000.0,1,1,180000,190000,-10000
38,3,2,8000.0,1,1,221000,169000,52000
50,3,4,210000.0,1,1,1004000,715000,289000
35,5,2,10000.0,1,1,1004000,676000,328000
26,5,4,0.0,1,0,241000,143000,98000
33,3,4,0.0,1,1,241000,239000,2000
38,3,2,10000.0,1,1,532000,380000,152000
59,5,1,0.0,1,1,40000,39000,1000
27,5,4,0.0,1,0,4000,3000,1000
68,3,2,9000.0,2,1,317000,240000,77000
32,3,2,10000.0,1,1,442000,347000,95000
28,3,2,10000.0,1,1,884000,648000,236000
26,3,4,0.0,1,0,60000,39000,21000
52,1,3,0.0,1,1,120000,111000,9000
25,4,0,0.0,0,1,282000,253000,29000
30,1,0,42000.0,0,0,52000,51000,1000
27,6,3,61000.0,1,1,402000,314000,88000
35,6,3,206000.0,1,1,964000,496000,468000
40,4,1,0.0,1,0,321000,274000,47000
39,4,3,69000.0,1,0,402000,324000,78000
30,6,1,0.0,1,1,241000,300000,-59000
30,1,0,0.0,0,1,32000,40000,-8000
27,4,0,0.0,1,1,282000,255000,27000
28,6,0,0.0,1,1,261000,247000,14000
35,4,4,0.0,1,1,201000,227000,-26000
37,6,1,0.0,1,1,180000,167000,13000
32,6,1,0.0,1,1,180000,197000,-17000
32,6,3,5000.0,1,1,180000,148000,32000
29,3,4,0.0,0,1,261000,152000,109000
28,6,1,0.0,1,1,302000,302000,0
22,3,3,69000.0,0,1,402000,310000,92000
28,6,3,61000.0,1,1,402000,212000,190000
45,6,3,68000.0,0,1,402000,308000,94000
50,3,3,9000.0,1,1,289000,223000,66000
28,4,3,69000.0,0,0,402000,325000,77000
35,3,3,37000.0,1,1,341000,442000,-101000
29,3,2,10000.0,0,0,602000,435000,167000
29,4,2,3000.0,1,1,81000,99000,-18000
54,6,2,93000.0,1,1,446000,346000,100000
52,4,0,0.0,0,1,282000,299000,-17000
30,6,0,0.0,0,1,402000,429000,-27000
22,3,2,4000.0,0,1,72000,93000,-21000
35,8,1,0.0,0,1,482000,333000,149000
37,6,3,25000.0,1,1,282000,298000,-16000
38,1,0,0.0,0,1,49000,48000,1000
18,4,3,70000.0,1,0,402000,294000,108000
27,3,4,0.0,1,1,261000,160000,101000
34,3,2,9000.0,1,1,402000,307000,95000
50,1,2,7000.0,0,1,49000,68000,-19000
40,4,3,35000.0,1,1,321000,302000,19000
18,4,2,275000.0,0,1,120000,174000,-54000
33,6,3,715000.0,1,1,1526000,798000,728000
30,8,4,138000.0,1,1,602000,342000,260000
28,3,4,0.0,1,1,60000,56000,4000
30,8,3,237000.0,1,1,964000,556000,408000
30,3,4,0.0,1,1,120000,134000,-14000
35,3,3,9000.0,1,0,289000,241000,48000
45,1,5,50000.0,1,1,233000,267000,-34000
20,3,3,0.0,1,1,261000,234000,27000
24,4,3,81000.0,1,0,482000,371000,111000
32,4,3,39000.0,1,1,361000,298000,63000
28,4,3,208000.0,1,0,289000,308000,-19000
45,3,3,48000.0,1,1,289000,227000,62000
38,1,2,10000.0,1,1,241000,253000,-12000
25,6,3,1000.0,1,1,40000,44000,-4000
54,3,3,74000.0,1,1,482000,304000,178000
40,1,3,6000.0,1,1,40000,198000,-158000
29,3,3,2000.0,1,0,40000,41000,-1000
57,1,2,10000.0,1,1,241000,323000,-82000
28,4,4,0.0,1,1,81000,59000,22000
20,3,3,2000.0,1,0,40000,50000,-10000
35,3,3,40000.0,1,1,241000,169000,72000
20,3,3,2000.0,1,1,40000,43000,-3000
66,3,3,8000.0,1,1,201000,262000,-61000
43,1,3,0.0,1,1,101000,86000,15000
35,4,0,0.0,1,1,201000,178000,23000
22,6,3,4000.0,1,0,160000,305000,-145000
30,4,0,0.0,1,0,321000,406000,-85000
27,1,3,0.0,1,1,81000,69000,12000
20,1,3,0.0,1,1,81000,78000,3000
38,3,0,0.0,1,1,81000,82000,-1000
29,4,3,6000.0,1,1,160000,233000,-73000
28,4,3,6000.0,1,1,160000,288000,-128000
41,3,3,8000.0,1,1,241000,269000,-28000
75,3,3,2000.0,1,1,40000,44000,-4000
21,3,3,82000.0,1,0,482000,389000,93000
24,6,3,1000.0,1,0,40000,40000,0
40,3,3,2000.0,1,1,40000,33000,7000
18,1,3,6000.0,1,0,40000,119000,-79000
24,3,3,2000.0,1,1,40000,114000,-74000
29,3,3,74000.0,1,0,482000,310000,172000
28,1,3,42000.0,1,0,241000,153000,88000
30,4,4,138000.0,1,0,562000,425000,137000
35,3,3,2000.0,1,1,40000,49000,-9000
28,3,3,74000.0,1,1,482000,312000,170000
66,3,3,2000.0,1,1,40000,42000,-2000
27,1,2,10000.0,1,1,282000,273000,9000
42,3,3,2000.0,1,1,40000,43000,-3000
22,6,3,1000.0,1,0,40000,41000,-1000
35,3,3,74000.0,1,1,482000,248000,234000
35,4,3,1000.0,1,1,40000,28000,12000
20,1,3,74000.0,1,0,482000,304000,178000
29,6,3,72000.0,1,0,482000,332000,150000
20,1,3,6000.0,1,0,40000,42000,-2000
18,4,0,0.0,1,1,201000,195000,6000
45,1,0,0.0,1,1,40000,36000,4000
36,3,0,0.0,1,1,140000,119000,21000
35,3,0,0.0,1,1,81000,86000,-5000
35,6,3,55000.0,1,1,321000,274000,47000
46,1,2,9000.0,1,0,96000,160000,-64000
25,3,0,0.0,1,1,160000,149000,11000
30,3,0,0.0,1,1,160000,161000,-1000
45,6,3,6000.0,1,1,241000,289000,-48000
25,3,0,0.0,1,0,241000,247000,-6000
26,1,1,0.0,1,1,60000,72000,-12000
38,4,3,33000.0,1,1,302000,221000,81000
39,6,1,0.0,1,1,402000,303000,99000
48,3,3,0.0,1,1,402000,336000,66000
33,4,3,405000.0,1,1,803000,390000,413000
35,4,3,0.0,0,1,482000,349000,133000
32,3,1,0.0,1,1,120000,141000,-21000
66,3,5,100000.0,1,1,803000,703000,100000
48,3,5,0.0,1,1,402000,377000,25000
23,4,3,100000.0,1,1,602000,474000,128000
35,3,5,9000.0,1,1,402000,343000,59000
25,3,3,69000.0,1,1,402000,299000,103000
92,1,2,10000.0,1,1,402000,337000,65000
80,3,4,69000.0,1,1,402000,285000,117000
58,4,5,0.0,1,1,402000,374000,28000
40,1,5,10000.0,0,1,160000,165000,-5000
48,4,4,69000.0,1,1,402000,235000,167000
22,4,3,316700.0,1,1,1004000,436000,568000
58,3,4,140000.0,1,1,602000,455000,147000
27,3,4,69000.0,1,1,402000,240000,162000
32,3,2,9000.0,1,0,402000,302000,100000
36,4,5,0.0,1,1,482000,362000,120000
30,3,3,15000.0,0,1,602000,424000,178000
45,3,3,96000.0,0,1,578000,410000,168000
53,3,2,20000.0,1,1,602000,434000,168000
27,3,5,9000.0,0,1,282000,227000,55000
65,3,5,0.0,0,1,402000,327000,75000
51,6,0,0.0,0,1,282000,349000,-67000
22,4,5,0.0,1,1,402000,371000,31000
34,6,3,0.0,1,0,562000,469000,93000
51,4,0,0.0,0,1,282000,247000,35000
50,3,4,185000.0,1,1,803000,475000,328000
30,6,5,15000.0,0,1,1205000,651000,554000
19,6,3,210000.0,1,1,803000,429000,374000
25,4,3,2000.0,1,1,402000,348000,54000
29,4,3,100000.0,1,1,602000,400000,202000
41,4,5,0.0,1,1,402000,341000,61000
45,1,3,0.0,1,1,81000,76000,5000
36,4,5,7000.0,0,1,402000,399000,3000
28,4,5,9000.0,1,1,402000,366000,36000
42,3,5,0.0,1,1,402000,365000,37000
25,6,4,125000.0,1,1,803000,461000,342000
26,6,4,230000.0,1,1,1205000,753000,452000
60,6,4,47000.0,1,1,402000,246000,156000
49,6,0,0.0,1,0,120000,108000,12000
35,4,0,0.0,1,1,101000,83000,18000
45,4,0,14600.0,1,1,201000,201000,0
55,4,2,11500.0,1,1,209000,156000,53000
60,6,0,0.0,1,1,140000,130000,10000
25,4,2,11500.0,1,1,209000,172000,37000
66,6,0,0.0,1,1,120000,102000,18000
18,3,2,8000.0,1,1,180000,281000,-101000
42,6,0,2500.0,1,0,282000,249000,33000
32,4,2,10000.0,1,0,282000,205000,77000
32,4,0,0.0,1,0,101000,90000,11000
36,6,0,2000.0,1,1,241000,229000,12000
27,10,2,4000.0,1,1,282000,229000,53000
32,6,2,8000.0,1,1,402000,281000,121000
30,6,2,7000.0,1,1,321000,259000,62000
18,6,2,8000.0,1,1,482000,376000,106000
26,10,2,6000.0,1,1,402000,331000,71000
35,6,4,30000.0,0,1,201000,161000,40000
26,1,2,10000.0,1,0,562000,452000,110000
30,3,5,33000.0,1,1,402000,358000,44000
50,6,5,0.0,1,1,602000,419000,183000
32,3,3,0.0,1,0,321000,303000,18000
30,6,5,9000.0,1,1,724000,488000,236000
55,3,4,0.0,1,0,81000,50000,31000
50,4,0,0.0,1,1,241000,231000,10000
32,4,4,0.0,1,0,120000,72000,48000
37,4,3,7000.0,1,1,241000,171000,70000
26,3,4,0.0,1,0,120000,83000,37000
25,3,4,140000.0,0,0,602000,337000,265000
45,6,1,0.0,1,0,241000,210000,31000
36,6,5,50000.0,0,0,643000,485000,158000
30,6,3,33000.0,0,0,502000,373000,129000
27,4,3,81000.0,1,1,482000,360000,122000
36,4,3,49000.0,0,1,361000,372000,-11000
25,4,4,156000.0,0,1,442000,301000,141000
35,8,0,13000.0,0,1,602000,405000,197000
36,4,4,0.0,0,1,160000,122000,38000
24,6,4,53000.0,0,1,321000,202000,119000
26,4,0,43000.0,0,1,321000,297000,24000
32,4,0,0.0,1,1,201000,186000,15000
28,6,4,139000.0,0,1,602000,350000,252000
25,6,4,139000.0,1,1,602000,400000,202000
34,3,0,0.0,1,1,160000,141000,19000
30,3,5,9000.0,0,1,341000,343000,-2000
29,6,4,82000.0,1,1,482000,324000,158000
26,6,4,68000.0,1,0,402000,531000,-129000
38,3,1,0.0,0,1,241000,206000,35000
30,6,3,3000.0,1,1,120000,167000,-47000
18,3,4,0.0,0,1,221000,148000,73000
37,3,4,84000.0,0,1,482000,306000,176000
20,3,1,0.0,1,1,160000,148000,12000
30,3,4,0.0,1,1,101000,73000,28000
40,3,0,0.0,0,1,241000,271000,-30000
31,6,4,0.0,1,1,160000,132000,28000
30,3,1,0.0,0,0,120000,97000,23000
26,3,3,37000.0,0,1,221000,156000,65000
30,6,1,10000.0,0,0,250000,207000,43000
45,8,3,0.0,0,1,844000,737000,107000
61,3,4,0.0,1,1,81000,41000,40000
33,3,4,0.0,1,1,81000,66000,15000
32,6,5,200000.0,1,1,1880000,1370000,510000
28,8,5,2245000.0,1,1,2891000,1106000,1785000
26,6,3,780000.0,0,1,1808000,1037000,771000
45,8,5,0.0,0,1,844000,561000,283000
27,3,4,0.0,2,1,120000,89000,31000
42,3,2,7000.0,0,1,171000,195000,-24000
32,4,5,10000.0,0,1,724000,485000,239000
28,6,1,0.0,0,1,169000,160000,9000
45,3,4,1000.0,2,1,120000,202000,-82000
30,3,4,0.0,2,1,81000,115000,-34000
31,3,4,0.0,1,0,160000,128000,32000
42,3,4,0.0,1,1,120000,133000,-13000
69,3,1,0.0,0,1,192000,224000,-32000
42,6,5,450000.0,1,1,2891000,2065000,826000
28,4,4,0.0,1,1,160000,136000,24000
22,6,1,0.0,0,1,192000,230000,-38000
31,6,0,38000.0,0,1,402000,424000,-22000
28,3,4,0.0,1,1,81000,47000,34000
37,4,4,47000.0,1,1,241000,177000,64000
28,4,0,91000.0,0,1,321000,258000,63000
33,6,0,22000.0,0,1,321000,311000,10000
23,4,0,43000.0,0,1,321000,321000,0
21,6,4,0.0,1,1,120000,90000,30000
35,3,4,69000.0,1,0,402000,543000,-141000
31,10,0,25000.0,0,1,321000,282000,39000
35,3,4,0.0,1,1,81000,56000,25000
22,3,3,29000.0,0,1,321000,288000,33000
31,3,4,84000.0,1,1,482000,509000,-27000
35,6,0,22000.0,0,1,321000,326000,-5000
40,6,0,0.0,1,1,201000,191000,10000
24,3,4,602000.0,1,0,1446000,768000,678000
27,1,1,0.0,1,0,36000,36000,0
35,6,3,1395500.0,1,1,1960000,735000,1225000
45,3,5,10000.0,0,1,1205000,664000,541000
26,3,3,4000.0,1,0,72000,80000,-8000
27,6,1,0.0,0,1,165000,214000,-49000
37,4,1,140000.0,1,1,185000,189000,-4000
42,6,3,2000.0,1,1,84000,95000,-11000
24,4,3,3000.0,1,0,72000,72000,0
18,3,1,0.0,0,1,233000,166000,67000
31,4,1,0.0,0,1,289000,349000,-60000
26,6,3,8000.0,1,1,96000,92000,4000
38,4,3,5000.0,1,1,140000,129000,11000
37,3,4,0.0,1,1,40000,46000,-6000
32,3,4,0.0,2,1,81000,73000,8000
56,6,3,2000.0,1,1,81000,80000,1000
27,3,4,0.0,2,1,160000,106000,54000
41,6,3,2000.0,1,1,81000,96000,-15000
42,3,4,335000.0,2,1,1205000,706000,499000
29,3,4,0.0,2,0,120000,159000,-39000
29,4,5,6000.0,1,0,160000,312000,-152000
40,3,4,0.0,2,1,120000,129000,-9000
32,4,3,2000.0,1,0,60000,58000,2000
51,3,3,2000.0,1,1,40000,48000,-8000
60,3,0,0.0,0,1,101000,91000,10000
35,6,4,0.0,0,1,180000,116000,64000
18,10,3,23000.0,1,1,282000,204000,78000
60,6,4,7000.0,1,1,201000,132000,69000
27,6,3,25000.0,0,1,282000,246000,36000
33,10,3,1150000.0,1,0,1948000,696000,1252000
38,4,0,0.0,0,1,101000,93000,8000
45,10,3,53000.0,0,1,321000,237000,84000
28,8,4,0.0,1,0,241000,182000,59000
32,8,3,51000.0,1,1,302000,254000,48000
39,8,3,17000.0,1,1,201000,199000,2000
37,3,3,6000.0,0,1,128000,122000,6000
40,6,0,0.0,0,1,241000,232000,9000
50,3,4,0.0,0,1,180000,138000,42000
28,6,1,0.0,0,1,241000,171000,70000
37,8,0,0.0,1,1,241000,256000,-15000
37,6,3,5000.0,1,1,201000,192000,9000
30,3,3,94000.0,1,1,562000,360000,202000
34,6,4,68000.0,1,1,402000,244000,158000
68,6,3,68000.0,1,1,402000,310000,92000
24,6,2,6000.0,0,1,282000,212000,70000
20,4,3,35000.0,0,1,321000,237000,84000
59,4,3,35000.0,0,1,321000,238000,83000
62,6,3,212000.0,0,1,1024000,571000,453000
18,8,4,231000.0,1,1,771000,589000,182000
62,6,4,86000.0,0,1,402000,245000,157000
32,4,5,17000.0,0,1,221000,262000,-41000
38,4,1,0.0,0,1,321000,280000,41000
27,6,1,0.0,0,0,241000,182000,59000
44,4,3,0.0,0,1,402000,380000,22000
30,3,4,0.0,1,1,81000,107000,-26000
72,3,4,0.0,1,1,160000,95000,65000
32,4,3,3000.0,1,1,72000,78000,-6000
26,3,3,4000.0,1,1,84000,90000,-6000
26,3,4,0.0,2,1,160000,106000,54000
42,3,4,0.0,1,1,160000,124000,36000
18,3,4,0.0,1,1,81000,65000,16000
52,4,3,3000.0,1,1,72000,71000,1000
27,3,3,5000.0,1,1,96000,107000,-11000
32,3,4,0.0,2,1,120000,86000,34000
27,3,4,0.0,1,1,160000,122000,38000
55,3,3,4000.0,1,1,84000,97000,-13000
24,3,3,5000.0,1,0,108000,107000,1000
40,3,3,3000.0,1,1,60000,70000,-10000
24,3,3,4000.0,1,1,81000,330000,-249000
25,4,3,6000.0,1,1,160000,421000,-261000
18,4,3,2000.0,1,1,60000,65000,-5000
26,8,3,95000.0,0,1,541000,586000,-45000
25,1,3,6000.0,1,1,40000,82000,-42000
18,6,5,50000.0,0,1,703000,630000,73000
39,3,3,7000.0,1,1,160000,189000,-29000
32,4,3,7000.0,1,1,201000,133000,68000
49,4,1,0.0,1,1,201000,264000,-63000
48,3,0,0.0,1,1,120000,108000,12000
24,3,2,8000.0,1,1,201000,183000,18000
18,6,3,6000.0,1,1,241000,173000,68000
40,6,3,5000.0,1,1,201000,138000,63000
66,3,0,0.0,1,1,201000,211000,-10000
32,4,5,411000.0,0,1,1567000,699000,868000
64,4,5,10000.0,0,1,724000,525000,199000
30,6,1,0.0,0,1,241000,202000,39000
23,3,3,505000.0,1,1,1366000,565000,801000
40,8,1,0.0,0,1,241000,206000,35000
48,4,1,0.0,0,1,160000,184000,-24000
39,3,3,6000.0,1,0,120000,174000,-54000
21,6,3,316000.0,0,0,964000,454000,510000
40,4,1,3000.0,1,1,224000,208000,16000
30,6,5,10000.0,0,1,1205000,710000,495000
24,6,4,602000.0,1,1,1446000,961000,485000
34,3,4,0.0,1,1,120000,182000,-62000
27,3,4,0.0,1,1,81000,61000,20000
28,6,4,214000.0,0,1,1044000,610000,434000
43,3,4,0.0,2,1,160000,107000,53000
25,3,4,0.0,1,1,81000,55000,26000
28,4,4,0.0,2,0,81000,89000,-8000
19,6,3,2000.0,1,0,84000,100000,-16000
36,6,4,0.0,1,1,221000,139000,82000
25,4,4,0.0,0,1,282000,329000,-47000
25,3,4,0.0,1,1,81000,49000,32000
48,6,3,4000.0,1,0,52000,55000,-3000
45,4,3,3000.0,1,1,84000,84000,0
22,3,3,46000.0,1,1,282000,190000,92000
22,3,4,30000.0,2,1,81000,98000,-17000
50,8,3,14000.0,1,1,160000,187000,-27000
47,4,3,3000.0,1,1,84000,75000,9000
32,3,4,0.0,2,1,120000,206000,-86000
28,6,3,2000.0,1,1,72000,76000,-4000
26,3,4,30000.0,1,1,81000,68000,13000
25,6,3,2000.0,1,1,84000,79000,5000
23,4,3,3000.0,1,1,84000,76000,8000
52,3,4,0.0,0,1,160000,125000,35000
48,3,3,6000.0,1,1,120000,115000,5000
23,3,3,3000.0,1,1,60000,57000,3000
58,6,3,8000.0,1,1,96000,96000,0
23,1,0,0.0,1,1,56000,50000,6000
35,3,5,10000.0,1,1,1205000,652000,553000
29,4,1,0.0,1,1,192000,212000,-20000
41,4,4,481000.0,1,1,1286000,868000,418000
48,6,3,0.0,1,1,867000,645000,222000
42,3,1,0.0,0,1,145000,138000,7000
35,3,2,5000.0,0,1,96000,86000,10000
55,6,1,0.0,1,1,289000,259000,30000
40,8,4,481000.0,1,1,1286000,689000,597000
33,4,0,0.0,1,1,201000,173000,28000
47,6,3,1000.0,1,1,40000,147000,-107000
50,3,3,74000.0,1,1,482000,235000,247000
40,4,3,73000.0,0,1,482000,236000,246000
22,4,3,73000.0,0,0,482000,236000,246000
65,4,3,6000.0,1,1,160000,139000,21000
30,4,3,99000.0,0,1,482000,257000,225000
47,3,4,84000.0,1,1,482000,289000,193000
31,3,3,311000.0,0,1,663000,394000,269000
27,6,4,82000.0,0,1,482000,303000,179000
28,3,4,0.0,1,1,282000,282000,0
28,3,4,0.0,1,0,160000,114000,46000
26,3,3,2000.0,1,1,49000,53000,-4000
44,3,4,0.0,1,1,160000,97000,63000
42,3,4,0.0,1,0,160000,220000,-60000
45,4,3,90000.0,0,1,602000,238000,364000
30,6,4,143000.0,0,1,321000,203000,118000
29,6,4,137000.0,1,1,562000,438000,124000
55,6,4,103000.0,1,1,562000,404000,158000
27,6,0,0.0,1,1,201000,173000,28000
62,4,4,140000.0,0,1,602000,438000,164000
19,4,4,75000.0,0,1,341000,211000,130000
34,3,0,0.0,1,1,201000,191000,10000
38,6,4,82000.0,0,1,482000,284000,198000
40,4,4,138000.0,0,0,562000,328000,234000
50,3,2,16000.0,0,1,120000,177000,-57000
20,4,0,32000.0,0,1,241000,261000,-20000
25,3,3,2000.0,1,1,40000,54000,-14000
62,4,4,0.0,1,1,81000,84000,-3000
27,1,2,10000.0,1,1,241000,274000,-33000
18,6,5,35000.0,0,1,361000,314000,47000
55,4,3,50000.0,0,1,482000,761000,-279000
28,3,3,24000.0,0,1,361000,438000,-77000
20,8,5,243000.0,0,1,482000,437000,45000
29,6,0,0.0,1,0,201000,172000,29000
50,6,0,0.0,1,1,201000,172000,29000
38,6,5,50000.0,0,1,502000,434000,68000
36,3,4,0.0,1,1,241000,332000,-91000
28,4,3,90000.0,1,1,602000,419000,183000
28,4,4,94000.0,1,1,402000,425000,-23000
27,4,3,28000.0,0,1,341000,329000,12000
42,3,0,83000.0,0,1,201000,177000,24000
35,3,0,33000.0,0,1,241000,233000,8000
26,3,4,0.0,1,1,120000,98000,22000
24,3,3,4000.0,1,0,81000,325000,-244000
27,3,4,0.0,1,1,160000,144000,16000
24,4,4,3500.0,1,0,120000,98000,22000
56,3,2,9000.0,1,0,321000,463000,-142000
71,4,0,33000.0,0,1,321000,309000,12000
28,6,5,50000.0,0,1,482000,443000,39000
46,6,3,100000.0,0,1,562000,262000,300000
35,3,2,34000.0,0,1,321000,362000,-41000
45,3,3,4000.0,1,0,81000,83000,-2000
24,1,3,9000.0,1,1,120000,90000,30000
30,4,3,6000.0,1,1,160000,145000,15000
24,6,3,42000.0,1,0,81000,279000,-198000
25,3,3,2000.0,1,0,40000,43000,-3000
28,4,4,17000.0,1,1,81000,55000,26000
25,3,3,71500.0,1,1,482000,278000,204000
24,3,3,6000.0,1,0,120000,82000,38000
24,1,3,8000.0,1,0,81000,304000,-223000
24,1,5,8000.0,1,0,81000,103000,-22000
30,6,3,2000.0,1,0,81000,201000,-120000
32,1,4,0.0,1,1,40000,33000,7000
34,3,3,7000.0,1,1,160000,97000,63000
55,3,3,4000.0,1,1,81000,329000,-248000
28,4,3,3000.0,1,1,81000,82000,-1000
34,3,3,7000.0,1,1,160000,188000,-28000
35,3,3,253000.0,2,1,505000,345000,160000
51,3,3,189000.0,2,0,275000,177000,98000
32,3,3,202500.0,2,1,282000,181000,101000
24,3,3,153000.0,2,1,268000,259000,9000
22,5,5,4000.0,0,1,119000,149000,-30000
29,12,5,3000.0,1,0,253000,235000,18000
45,4,5,5000.0,0,1,119000,129000,-10000
40,8,5,31000.0,1,1,342000,317000,25000
55,9,5,2000.0,0,1,119000,176000,-57000
48,4,5,7000.0,0,1,223000,201000,22000
48,3,5,15000.0,0,1,134000,207000,-73000
22,4,5,7000.0,1,1,223000,246000,-23000
25,13,5,10000.0,1,1,223000,215000,8000
28,4,5,6000.0,0,1,178000,235000,-57000
27,8,5,4000.0,0,1,223000,234000,-11000
25,10,5,2000.0,0,1,119000,163000,-44000
22,4,5,10000.0,0,1,194000,232000,-38000
35,4,4,0.0,0,1,89000,75000,14000
25,4,5,7000.0,0,1,194000,257000,-63000
33,4,5,50000.0,1,1,416000,330000,86000
35,5,5,3000.0,0,1,89000,141000,-52000
49,5,1,64000.0,1,0,104000,103000,1000
48,4,4,200000.0,2,1,698000,468000,230000
20,3,3,750000.0,1,1,1783000,900000,883000
19,4,3,697000.0,1,1,669000,592000,77000
28,8,3,610000.0,1,1,1189000,688000,501000
20,3,4,170000.0,2,1,894000,506000,388000
45,2,5,105000.0,2,0,520000,331000,189000
60,5,3,3000.0,1,1,104000,244000,-140000
48,3,4,0.0,0,0,18000,12000,6000
62,2,4,2000.0,0,1,22000,17000,5000
34,3,4,0.0,0,1,22000,19000,3000
35,3,4,0.0,0,0,15000,10000,5000
35,3,3,41000.0,1,1,253000,277000,-24000
50,2,4,2000.0,0,1,22000,19000,3000
30,3,0,0.0,0,1,119000,107000,12000
27,9,4,0.0,0,1,119000,84000,35000
26,8,4,0.0,0,0,15000,17000,-2000
43,5,4,7000.0,1,0,22000,22000,0
45,3,5,30000.0,1,0,312000,332000,-20000
18,5,3,72000.0,1,1,520000,228000,292000
23,3,0,4000.0,1,1,66000,65000,1000
26,8,0,1000.0,1,1,52000,44000,8000
36,3,4,0.0,1,1,208000,145000,63000
28,4,2,4000.0,0,1,104000,165000,-61000
38,1,0,2000.0,1,1,12000,13000,-1000
24,4,2,5000.0,1,0,119000,153000,-34000
26,3,0,0.0,1,1,66000,59000,7000
43,5,5,6000.0,0,1,223000,178000,45000
45,4,4,54000.0,0,0,327000,247000,80000
65,4,5,8000.0,0,1,253000,276000,-23000
28,2,5,9000.0,0,1,268000,271000,-3000
50,2,5,10000.0,0,1,282000,272000,10000
65,2,5,8000.0,0,1,148000,172000,-24000
57,2,5,10000.0,0,1,282000,206000,76000
26,8,3,73500.0,1,0,442000,357000,85000
42,9,4,230000.0,1,1,614000,476000,138000
34,12,4,140000.0,1,1,511000,346000,165000
45,11,4,150000.0,1,1,602000,361000,241000
23,9,4,130000.0,1,1,511000,298000,213000
29,3,4,0.0,1,0,121000,84000,37000
30,4,3,90000.0,1,1,541000,394000,147000
30,3,1,0.0,1,1,60000,60000,0
55,4,5,8000.0,1,1,321000,288000,33000
37,4,3,36000.0,1,1,341000,269000,72000
55,6,3,25000.0,1,1,282000,295000,-13000
61,4,1,0.0,1,1,282000,274000,8000
28,4,1,0.0,1,1,282000,237000,45000
25,3,3,8000.0,1,0,201000,259000,-58000
33,3,5,60000.0,1,0,803000,586000,217000
